sen_id	gold	gr100_basic_keep	gr100_max_keep	gr100_prec_keep	gr100_rec_keep	gr100_f1_keep	gr200_basic_keep	gr200_max_keep	random_boa	gr100_basic_keep - gold	gr100_max_keep - gold	gr100_prec_keep - gold	gr100_rec_keep - gold	gr100_f1_keep - gold	gr200_basic_keep - gold	gr200_max_keep - gold	random_boa - gold
0	4	10	1	2	2	2	10	7	2	6	-3	-2	-2	-2	6	3	-2
4	2	10	10	1	1	1	10	10	1	8	8	-1	-1	-1	8	8	-1
6	1	10	8	0	0	0	10	10	4	9	7	-1	-1	-1	9	9	3
7	1	10	6	1	1	1	10	3	8	9	5	0	0	0	9	2	7
8	3	9	4	1	1	1	10	10	2	6	1	-2	-2	-2	7	7	-1
11	1	10	4	0	0	0	10	2	2	9	3	-1	-1	-1	9	1	1
12	4	10	10	1	1	1	10	10	2	6	6	-3	-3	-3	6	6	-2
16	1	10	10	1	1	1	10	10	4	9	9	0	0	0	9	9	3
17	3	10	2	2	2	2	10	10	3	7	-1	-1	-1	-1	7	7	0
20	4	10	6	2	2	2	10	10	2	6	2	-2	-2	-2	6	6	-2
24	9	10	10	2	2	2	10	9	5	1	1	-7	-7	-7	1	0	-4
33	4	10	10	2	2	2	10	10	3	6	6	-2	-2	-2	6	6	-1
37	1	10	2	1	1	1	10	6	1	9	1	0	0	0	9	5	0
38	2	6	1	1	1	1	10	1	3	4	-1	-1	-1	-1	8	-1	1
40	1	10	1	1	1	1	10	2	1	9	0	0	0	0	9	1	0
41	1	10	1	1	1	1	10	4	4	9	0	0	0	0	9	3	3
42	1	10	10	0	0	0	10	10	3	9	9	-1	-1	-1	9	9	2
43	2	10	6	2	2	2	10	1	3	8	4	0	0	0	8	-1	1
45	1	10	3	1	1	1	10	1	2	9	2	0	0	0	9	0	1
46	2	10	1	2	2	2	10	10	3	8	-1	0	0	0	8	8	1
48	2	10	1	1	1	1	10	8	4	8	-1	-1	-1	-1	8	6	2
50	1	10	1	1	1	1	10	1	4	9	0	0	0	0	9	0	3
51	1	10	1	1	1	1	10	10	4	9	0	0	0	0	9	9	3
52	1	10	10	1	1	1	10	4	1	9	9	0	0	0	9	3	0
53	2	10	3	2	2	2	10	10	3	8	1	0	0	0	8	8	1
55	2	10	1	2	2	2	10	2	3	8	-1	0	0	0	8	0	1
57	1	10	8	1	1	1	10	5	1	9	7	0	0	0	9	4	0
58	1	4	1	1	1	1	10	10	1	3	0	0	0	0	9	9	0
59	3	10	1	2	2	2	10	1	2	7	-2	-1	-1	-1	7	-2	-1
62	2	10	3	1	1	1	10	1	1	8	1	-1	-1	-1	8	-1	-1
64	3	10	2	3	3	3	10	10	2	7	-1	0	0	0	7	7	-1
67	2	10	1	1	1	1	10	1	4	8	-1	-1	-1	-1	8	-1	2
69	2	10	9	2	2	2	10	10	1	8	7	0	0	0	8	8	-1
71	1	10	4	1	1	1	10	6	1	9	3	0	0	0	9	5	0
72	5	10	10	4	4	4	10	10	4	5	5	-1	-1	-1	5	5	-1
77	4	10	4	4	4	4	10	10	2	6	0	0	0	0	6	6	-2
81	3	10	2	2	3	3	10	3	2	7	-1	-1	0	0	7	0	-1
84	2	10	1	0	0	0	10	10	2	8	-1	-2	-2	-2	8	8	0
86	1	10	10	1	1	1	10	10	2	9	9	0	0	0	9	9	1
87	3	10	1	1	1	1	10	10	1	7	-2	-2	-2	-2	7	7	-2
90	1	10	10	0	0	0	10	10	2	9	9	-1	-1	-1	9	9	1
91	3	10	1	2	2	2	10	6	3	7	-2	-1	-1	-1	7	3	0
94	1	10	9	0	0	0	10	10	1	9	8	-1	-1	-1	9	9	0
95	3	10	2	1	1	1	10	2	3	7	-1	-2	-2	-2	7	-1	0
98	1	10	1	0	0	0	10	1	1	9	0	-1	-1	-1	9	0	0
99	1	10	2	1	1	1	10	3	1	9	1	0	0	0	9	2	0
100	1	2	1	0	0	0	10	4	1	1	0	-1	-1	-1	9	3	0
101	3	10	2	2	2	2	10	1	4	7	-1	-1	-1	-1	7	-2	1
104	1	10	1	1	1	1	10	2	5	9	0	0	0	0	9	1	4
105	2	10	2	2	2	2	10	2	1	8	0	0	0	0	8	0	-1
107	3	10	10	2	2	2	10	10	1	7	7	-1	-1	-1	7	7	-2
110	2	10	1	1	1	1	10	10	2	8	-1	-1	-1	-1	8	8	0
112	2	10	1	0	0	0	10	1	5	8	-1	-2	-2	-2	8	-1	3
114	1	10	6	1	1	1	10	4	2	9	5	0	0	0	9	3	1
115	2	8	1	0	0	0	10	2	1	6	-1	-2	-2	-2	8	0	-1
117	1	10	6	1	1	1	10	4	1	9	5	0	0	0	9	3	0
118	2	10	5	0	0	0	10	10	2	8	3	-2	-2	-2	8	8	0
120	3	10	1	2	2	2	10	3	5	7	-2	-1	-1	-1	7	0	2
123	1	10	2	1	1	1	10	10	2	9	1	0	0	0	9	9	1
124	3	10	2	3	3	3	10	3	2	7	-1	0	0	0	7	0	-1
127	1	10	1	1	1	1	10	3	1	9	0	0	0	0	9	2	0
128	2	10	10	2	2	2	10	10	1	8	8	0	0	0	8	8	-1
130	1	10	10	1	1	1	10	4	5	9	9	0	0	0	9	3	4
131	2	10	2	1	1	1	10	3	6	8	0	-1	-1	-1	8	1	4
133	1	10	1	1	1	1	10	1	2	9	0	0	0	0	9	0	1
134	1	1	1	0	0	0	10	1	2	0	0	-1	-1	-1	9	0	1
135	2	10	3	2	2	2	10	4	5	8	1	0	0	0	8	2	3
137	4	10	2	3	3	3	10	3	2	6	-2	-1	-1	-1	6	-1	-2
141	2	10	2	2	2	2	10	1	2	8	0	0	0	0	8	-1	0
143	2	10	1	2	2	2	10	1	1	8	-1	0	0	0	8	-1	-1
145	1	10	1	1	1	1	10	3	3	9	0	0	0	0	9	2	2
146	1	10	1	0	0	0	10	3	1	9	0	-1	-1	-1	9	2	0
147	1	10	5	1	1	1	10	10	5	9	4	0	0	0	9	9	4
148	1	10	2	1	1	1	10	1	1	9	1	0	0	0	9	0	0
149	2	10	10	0	0	0	10	10	1	8	8	-2	-2	-2	8	8	-1
151	2	10	10	1	1	1	10	10	1	8	8	-1	-1	-1	8	8	-1
153	2	10	3	2	2	2	10	1	2	8	1	0	0	0	8	-1	0
155	2	10	2	2	2	2	10	1	1	8	0	0	0	0	8	-1	-1
157	2	10	2	2	2	2	10	1	2	8	0	0	0	0	8	-1	0
159	2	10	1	2	2	2	10	10	2	8	-1	0	0	0	8	8	0
161	2	10	1	2	2	2	10	3	3	8	-1	0	0	0	8	1	1
163	3	10	10	0	0	0	10	10	1	7	7	-3	-3	-3	7	7	-2
166	1	10	3	0	0	0	10	10	4	9	2	-1	-1	-1	9	9	3
167	3	10	2	3	3	3	10	3	2	7	-1	0	0	0	7	0	-1
170	4	10	1	4	4	4	10	10	3	6	-3	0	0	0	6	6	-1
174	2	10	1	2	2	2	10	3	2	8	-1	0	0	0	8	1	0
176	1	10	1	1	1	1	10	1	1	9	0	0	0	0	9	0	0
177	3	10	3	1	1	1	10	7	2	7	0	-2	-2	-2	7	4	-1
180	1	10	3	1	1	1	10	3	2	9	2	0	0	0	9	2	1
181	2	10	2	1	1	1	10	2	2	8	0	-1	-1	-1	8	0	0
183	3	10	2	2	2	2	10	4	1	7	-1	-1	-1	-1	7	1	-2
186	3	10	10	2	3	3	10	2	1	7	7	-1	0	0	7	-1	-2
189	1	10	3	1	1	1	10	3	2	9	2	0	0	0	9	2	1
190	1	10	10	0	0	0	10	4	2	9	9	-1	-1	-1	9	3	1
191	2	10	1	2	2	2	10	1	1	8	-1	0	0	0	8	-1	-1
193	3	10	1	1	1	1	10	2	3	7	-2	-2	-2	-2	7	-1	0
196	2	10	1	2	2	2	10	1	1	8	-1	0	0	0	8	-1	-1
198	1	10	1	1	1	1	10	2	2	9	0	0	0	0	9	1	1
199	3	10	10	1	1	1	10	10	5	7	7	-2	-2	-2	7	7	2
202	2	10	2	2	2	2	10	7	3	8	0	0	0	0	8	5	1
204	1	10	1	1	1	1	10	1	3	9	0	0	0	0	9	0	2
205	3	10	8	0	0	0	10	10	1	7	5	-3	-3	-3	7	7	-2
208	1	10	1	1	1	1	10	1	1	9	0	0	0	0	9	0	0
209	1	10	10	1	1	1	10	10	2	9	9	0	0	0	9	9	1
210	3	10	1	2	2	2	10	4	2	7	-2	-1	-1	-1	7	1	-1
213	1	5	1	1	1	1	10	3	1	4	0	0	0	0	9	2	0
214	6	10	2	1	1	1	10	10	2	4	-4	-5	-5	-5	4	4	-4
220	3	10	4	1	1	1	10	10	1	7	1	-2	-2	-2	7	7	-2
223	4	10	1	4	4	4	10	10	4	6	-3	0	0	0	6	6	0
227	6	10	10	2	2	2	10	10	2	4	4	-4	-4	-4	4	4	-4
233	5	10	3	1	1	1	10	3	4	5	-2	-4	-4	-4	5	-2	-1
238	2	10	1	2	2	2	10	5	2	8	-1	0	0	0	8	3	0
240	1	3	1	0	0	0	10	1	2	2	0	-1	-1	-1	9	0	1
241	1	10	10	1	1	1	10	3	2	9	9	0	0	0	9	2	1
242	3	10	1	1	1	1	10	9	3	7	-2	-2	-2	-2	7	6	0
245	4	10	3	1	1	1	10	10	2	6	-1	-3	-3	-3	6	6	-2
249	1	10	10	1	1	1	10	10	2	9	9	0	0	0	9	9	1
250	4	10	2	0	0	0	10	6	2	6	-2	-4	-4	-4	6	2	-2
254	2	10	3	1	1	1	10	7	1	8	1	-1	-1	-1	8	5	-1
256	5	10	6	2	2	2	10	10	2	5	1	-3	-3	-3	5	5	-3
261	6	10	3	1	1	1	10	10	3	4	-3	-5	-5	-5	4	4	-3
267	2	10	2	2	2	2	10	1	1	8	0	0	0	0	8	-1	-1
269	5	10	6	3	3	3	10	10	1	5	1	-2	-2	-2	5	5	-4
274	1	10	3	1	1	1	10	5	2	9	2	0	0	0	9	4	1
275	2	10	1	1	1	1	10	10	2	8	-1	-1	-1	-1	8	8	0
277	1	10	1	0	0	0	10	1	1	9	0	-1	-1	-1	9	0	0
278	1	10	8	1	1	1	10	10	1	9	7	0	0	0	9	9	0
279	1	10	2	1	1	1	10	5	2	9	1	0	0	0	9	4	1
280	2	10	2	1	1	1	10	3	2	8	0	-1	-1	-1	8	1	0
282	1	10	3	0	0	0	10	4	2	9	2	-1	-1	-1	9	3	1
283	1	10	6	1	1	1	10	10	3	9	5	0	0	0	9	9	2
284	1	10	3	1	1	1	10	1	1	9	2	0	0	0	9	0	0
285	4	10	10	2	2	2	10	10	3	6	6	-2	-2	-2	6	6	-1
289	4	10	1	1	1	1	10	10	1	6	-3	-3	-3	-3	6	6	-3
293	2	10	1	0	0	0	10	10	4	8	-1	-2	-2	-2	8	8	2
295	2	10	3	2	2	2	10	2	2	8	1	0	0	0	8	0	0
297	2	10	3	2	2	2	10	10	1	8	1	0	0	0	8	8	-1
299	7	10	10	3	3	3	10	10	3	3	3	-4	-4	-4	3	3	-4
306	2	10	1	0	0	0	10	10	1	8	-1	-2	-2	-2	8	8	-1
308	3	10	2	2	2	2	10	1	4	7	-1	-1	-1	-1	7	-2	1
311	2	10	1	1	1	1	10	2	3	8	-1	-1	-1	-1	8	0	1
313	2	10	10	2	2	2	10	10	4	8	8	0	0	0	8	8	2
315	3	10	4	2	2	2	10	10	2	7	1	-1	-1	-1	7	7	-1
318	1	10	2	0	0	0	10	1	3	9	1	-1	-1	-1	9	0	2
319	2	10	10	1	1	1	10	10	1	8	8	-1	-1	-1	8	8	-1
321	2	10	2	1	1	1	10	4	3	8	0	-1	-1	-1	8	2	1
323	2	10	3	2	2	2	10	10	3	8	1	0	0	0	8	8	1
325	2	10	2	2	2	2	10	2	4	8	0	0	0	0	8	0	2
327	1	10	1	1	1	1	10	10	2	9	0	0	0	0	9	9	1
328	1	10	2	1	1	1	10	5	1	9	1	0	0	0	9	4	0
329	4	10	10	1	1	1	10	10	3	6	6	-3	-3	-3	6	6	-1
333	2	10	8	1	1	1	10	10	1	8	6	-1	-1	-1	8	8	-1
335	1	10	1	1	1	1	10	1	2	9	0	0	0	0	9	0	1
336	2	10	2	1	1	1	10	3	2	8	0	-1	-1	-1	8	1	0
338	2	10	2	2	2	2	10	7	3	8	0	0	0	0	8	5	1
340	4	10	10	2	2	2	10	10	2	6	6	-2	-2	-2	6	6	-2
344	1	10	1	1	1	1	10	1	1	9	0	0	0	0	9	0	0
345	3	10	1	1	1	1	10	7	1	7	-2	-2	-2	-2	7	4	-2
348	2	10	10	0	0	0	10	10	2	8	8	-2	-2	-2	8	8	0
350	1	10	9	1	1	1	10	3	1	9	8	0	0	0	9	2	0
351	1	10	1	1	1	1	10	3	1	9	0	0	0	0	9	2	0
352	4	10	2	2	2	2	10	1	1	6	-2	-2	-2	-2	6	-3	-3
356	1	10	2	1	1	1	10	1	2	9	1	0	0	0	9	0	1
357	4	10	1	1	1	1	10	10	1	6	-3	-3	-3	-3	6	6	-3
361	3	10	1	2	2	2	10	10	6	7	-2	-1	-1	-1	7	7	3
364	2	10	1	2	2	2	10	10	1	8	-1	0	0	0	8	8	-1
366	2	10	2	1	1	1	10	2	3	8	0	-1	-1	-1	8	0	1
368	3	10	3	2	2	2	10	10	1	7	0	-1	-1	-1	7	7	-2
371	2	9	3	2	2	2	10	10	4	7	1	0	0	0	8	8	2
373	3	10	4	1	1	1	10	10	2	7	1	-2	-2	-2	7	7	-1
376	3	10	1	2	2	2	10	2	1	7	-2	-1	-1	-1	7	-1	-2
379	1	10	1	0	0	0	10	2	1	9	0	-1	-1	-1	9	1	0
380	3	10	4	2	2	2	10	1	3	7	1	-1	-1	-1	7	-2	0
383	3	10	1	2	2	2	10	3	2	7	-2	-1	-1	-1	7	0	-1
386	1	10	4	1	1	1	10	1	1	9	3	0	0	0	9	0	0
387	1	10	1	1	1	1	10	1	4	9	0	0	0	0	9	0	3
388	2	5	2	1	1	1	10	1	4	3	0	-1	-1	-1	8	-1	2
390	4	10	1	3	3	3	10	10	5	6	-3	-1	-1	-1	6	6	1
394	2	10	6	2	2	2	10	10	2	8	4	0	0	0	8	8	0
396	3	10	10	0	0	0	10	10	6	7	7	-3	-3	-3	7	7	3
399	3	10	10	1	1	1	10	10	1	7	7	-2	-2	-2	7	7	-2
402	3	10	10	0	0	0	10	10	4	7	7	-3	-3	-3	7	7	1
405	1	0	0	0	0	0	10	10	1	-1	-1	-1	-1	-1	9	9	0
406	2	10	3	2	2	2	10	10	2	8	1	0	0	0	8	8	0
408	4	10	1	3	3	3	10	2	2	6	-3	-1	-1	-1	6	-2	-2
412	2	10	10	1	1	1	10	10	1	8	8	-1	-1	-1	8	8	-1
414	2	10	4	1	1	1	10	10	2	8	2	-1	-1	-1	8	8	0
416	3	10	7	2	2	2	10	10	3	7	4	-1	-1	-1	7	7	0
419	5	10	10	2	2	2	10	10	3	5	5	-3	-3	-3	5	5	-2
424	1	10	1	1	1	1	10	1	1	9	0	0	0	0	9	0	0
425	4	10	2	2	2	2	10	10	1	6	-2	-2	-2	-2	6	6	-3
429	7	10	10	1	1	1	10	10	1	3	3	-6	-6	-6	3	3	-6
436	4	10	10	3	3	3	10	10	2	6	6	-1	-1	-1	6	6	-2
440	1	10	1	0	0	0	10	1	2	9	0	-1	-1	-1	9	0	1
441	1	10	10	1	1	1	10	10	2	9	9	0	0	0	9	9	1
442	4	10	10	1	1	1	10	10	2	6	6	-3	-3	-3	6	6	-2
446	2	10	3	1	1	1	10	1	4	8	1	-1	-1	-1	8	-1	2
448	4	10	2	3	3	3	10	3	1	6	-2	-1	-1	-1	6	-1	-3
452	1	10	2	1	1	1	10	4	4	9	1	0	0	0	9	3	3
453	1	10	6	1	1	1	10	10	1	9	5	0	0	0	9	9	0
454	3	10	1	2	2	2	10	6	1	7	-2	-1	-1	-1	7	3	-2
457	3	10	2	0	0	0	10	10	1	7	-1	-3	-3	-3	7	7	-2
460	3	10	1	0	0	0	10	7	2	7	-2	-3	-3	-3	7	4	-1
463	2	10	4	1	1	1	10	10	4	8	2	-1	-1	-1	8	8	2
465	1	10	2	1	1	1	10	10	1	9	1	0	0	0	9	9	0
466	3	10	4	1	1	1	10	8	5	7	1	-2	-2	-2	7	5	2
469	2	10	2	1	1	1	10	1	3	8	0	-1	-1	-1	8	-1	1
471	1	10	3	0	0	0	10	2	1	9	2	-1	-1	-1	9	1	0
472	2	10	3	2	2	2	10	10	1	8	1	0	0	0	8	8	-1
474	2	8	1	1	1	1	10	1	2	6	-1	-1	-1	-1	8	-1	0
476	3	10	10	3	3	3	10	10	2	7	7	0	0	0	7	7	-1
479	4	10	10	2	2	2	10	10	2	6	6	-2	-2	-2	6	6	-2
483	2	10	1	2	2	2	10	10	8	8	-1	0	0	0	8	8	6
485	2	10	10	2	2	2	10	10	3	8	8	0	0	0	8	8	1
487	1	10	2	1	1	1	10	10	3	9	1	0	0	0	9	9	2
488	2	10	1	2	2	2	10	1	1	8	-1	0	0	0	8	-1	-1
490	5	10	8	4	4	4	10	10	3	5	3	-1	-1	-1	5	5	-2
495	2	10	10	2	2	2	10	10	2	8	8	0	0	0	8	8	0
497	1	10	10	1	1	1	10	10	1	9	9	0	0	0	9	9	0
498	2	10	2	1	1	1	10	3	2	8	0	-1	-1	-1	8	1	0
500	1	10	1	1	1	1	10	2	1	9	0	0	0	0	9	1	0
501	1	10	3	1	1	1	10	1	1	9	2	0	0	0	9	0	0
502	1	10	1	1	1	1	10	10	2	9	0	0	0	0	9	9	1
503	1	10	3	1	1	1	10	2	1	9	2	0	0	0	9	1	0
504	1	10	4	1	1	1	10	10	1	9	3	0	0	0	9	9	0
505	1	10	1	1	1	1	10	10	1	9	0	0	0	0	9	9	0
506	2	10	6	2	2	2	10	10	4	8	4	0	0	0	8	8	2
508	2	10	10	2	2	2	10	10	3	8	8	0	0	0	8	8	1
510	1	10	1	1	1	1	10	1	3	9	0	0	0	0	9	0	2
511	1	5	1	1	1	1	10	1	3	4	0	0	0	0	9	0	2
512	4	10	1	3	3	3	10	10	1	6	-3	-1	-1	-1	6	6	-3
516	4	10	1	1	1	1	10	6	1	6	-3	-3	-3	-3	6	2	-3
520	4	10	10	3	3	3	10	10	1	6	6	-1	-1	-1	6	6	-3
524	9	10	10	3	3	3	10	10	3	1	1	-6	-6	-6	1	1	-6
533	2	10	2	2	2	2	10	1	2	8	0	0	0	0	8	-1	0
535	3	10	4	3	3	3	10	1	3	7	1	0	0	0	7	-2	0
538	7	10	3	2	2	2	10	10	3	3	-4	-5	-5	-5	3	3	-4
545	2	10	6	2	2	2	10	1	1	8	4	0	0	0	8	-1	-1
547	2	10	2	2	2	2	10	1	1	8	0	0	0	0	8	-1	-1
549	2	10	2	1	1	1	10	10	2	8	0	-1	-1	-1	8	8	0
551	2	10	6	1	1	1	10	4	1	8	4	-1	-1	-1	8	2	-1
553	5	10	1	4	4	4	10	10	6	5	-4	-1	-1	-1	5	5	1
558	2	10	2	1	1	1	10	9	1	8	0	-1	-1	-1	8	7	-1
560	1	7	1	0	0	0	10	3	1	6	0	-1	-1	-1	9	2	0
561	2	10	10	1	1	1	10	10	1	8	8	-1	-1	-1	8	8	-1
563	3	10	4	2	2	2	10	10	2	7	1	-1	-1	-1	7	7	-1
566	3	10	2	3	3	3	10	2	1	7	-1	0	0	0	7	-1	-2
569	5	10	10	0	0	0	10	10	2	5	5	-5	-5	-5	5	5	-3
574	2	10	1	1	2	2	10	8	2	8	-1	-1	0	0	8	6	0
576	2	10	6	0	0	0	10	10	4	8	4	-2	-2	-2	8	8	2
578	1	10	4	1	1	1	10	10	4	9	3	0	0	0	9	9	3
579	4	10	2	4	4	4	10	10	3	6	-2	0	0	0	6	6	-1
583	3	10	1	3	3	3	10	10	1	7	-2	0	0	0	7	7	-2
586	1	10	6	1	1	1	10	4	1	9	5	0	0	0	9	3	0
587	2	10	6	2	2	2	10	3	2	8	4	0	0	0	8	1	0
589	3	10	1	3	3	3	10	10	3	7	-2	0	0	0	7	7	0
592	3	10	1	3	3	3	10	10	3	7	-2	0	0	0	7	7	0
595	3	10	10	2	2	2	10	10	3	7	7	-1	-1	-1	7	7	0
598	1	10	1	1	1	1	10	1	2	9	0	0	0	0	9	0	1
599	1	10	3	0	0	0	10	4	2	9	2	-1	-1	-1	9	3	1
600	1	10	4	1	1	1	10	3	2	9	3	0	0	0	9	2	1
601	2	10	10	1	1	1	9	10	6	8	8	-1	-1	-1	7	8	4
603	1	10	1	0	0	0	10	2	2	9	0	-1	-1	-1	9	1	1
604	1	6	2	1	1	1	10	1	1	5	1	0	0	0	9	0	0
605	1	7	1	1	1	1	10	1	1	6	0	0	0	0	9	0	0
606	1	8	1	1	1	1	10	1	3	7	0	0	0	0	9	0	2
607	5	10	2	2	2	2	10	2	5	5	-3	-3	-3	-3	5	-3	0
612	1	10	3	1	1	1	10	7	2	9	2	0	0	0	9	6	1
613	2	10	4	1	1	1	10	6	1	8	2	-1	-1	-1	8	4	-1
615	2	10	6	1	2	2	10	10	3	8	4	-1	0	0	8	8	1
617	1	10	3	1	1	1	10	3	1	9	2	0	0	0	9	2	0
618	1	9	1	1	1	1	10	1	1	8	0	0	0	0	9	0	0
619	2	10	1	1	1	1	10	3	3	8	-1	-1	-1	-1	8	1	1
621	2	10	3	2	2	2	10	10	4	8	1	0	0	0	8	8	2
623	2	10	1	1	1	1	10	1	1	8	-1	-1	-1	-1	8	-1	-1
625	2	10	2	1	1	1	10	1	4	8	0	-1	-1	-1	8	-1	2
627	3	10	1	2	2	2	10	5	2	7	-2	-1	-1	-1	7	2	-1
630	2	1	1	0	0	0	10	2	4	-1	-1	-2	-2	-2	8	0	2
632	1	10	4	1	1	1	10	5	3	9	3	0	0	0	9	4	2
633	2	10	1	2	2	2	10	3	2	8	-1	0	0	0	8	1	0
635	1	10	2	1	1	1	10	10	1	9	1	0	0	0	9	9	0
636	5	10	2	1	1	1	10	2	5	5	-3	-4	-4	-4	5	-3	0
641	1	10	3	1	1	1	10	3	3	9	2	0	0	0	9	2	2
642	3	10	2	1	1	1	10	5	5	7	-1	-2	-2	-2	7	2	2
645	2	10	3	0	0	0	10	3	1	8	1	-2	-2	-2	8	1	-1
647	2	10	1	1	1	1	10	4	3	8	-1	-1	-1	-1	8	2	1
649	2	10	10	1	1	1	10	10	1	8	8	-1	-1	-1	8	8	-1
651	1	10	6	1	1	1	10	4	2	9	5	0	0	0	9	3	1
652	1	4	1	0	0	0	10	1	3	3	0	-1	-1	-1	9	0	2
653	2	10	1	1	1	1	10	1	1	8	-1	-1	-1	-1	8	-1	-1
655	1	10	1	1	1	1	10	1	1	9	0	0	0	0	9	0	0
656	1	10	2	0	0	0	10	3	3	9	1	-1	-1	-1	9	2	2
657	4	10	1	2	2	2	10	10	1	6	-3	-2	-2	-2	6	6	-3
661	2	10	1	0	0	0	10	6	3	8	-1	-2	-2	-2	8	4	1
663	1	10	10	0	0	0	10	10	1	9	9	-1	-1	-1	9	9	0
664	3	10	3	1	1	1	10	9	1	7	0	-2	-2	-2	7	6	-2
667	2	10	3	0	0	0	10	7	2	8	1	-2	-2	-2	8	5	0
669	1	10	6	1	1	1	10	8	2	9	5	0	0	0	9	7	1
670	1	10	6	1	1	1	10	2	4	9	5	0	0	0	9	1	3
671	1	10	2	1	1	1	10	2	4	9	1	0	0	0	9	1	3
672	1	10	10	1	1	1	10	10	2	9	9	0	0	0	9	9	1
673	2	10	3	0	0	0	10	3	5	8	1	-2	-2	-2	8	1	3
675	1	0	0	0	0	0	10	1	3	-1	-1	-1	-1	-1	9	0	2
676	1	10	1	1	1	1	10	1	1	9	0	0	0	0	9	0	0
677	3	10	2	2	2	2	10	6	2	7	-1	-1	-1	-1	7	3	-1
680	2	10	8	2	2	2	10	1	1	8	6	0	0	0	8	-1	-1
682	1	10	3	1	1	1	10	3	2	9	2	0	0	0	9	2	1
683	1	10	1	1	1	1	10	2	2	9	0	0	0	0	9	1	1
684	1	3	1	0	0	0	3	1	1	2	0	-1	-1	-1	2	0	0
685	4	10	2	3	3	3	10	1	2	6	-2	-1	-1	-1	6	-3	-2
689	2	10	1	2	2	2	10	1	3	8	-1	0	0	0	8	-1	1
691	5	10	1	3	3	3	10	3	2	5	-4	-2	-2	-2	5	-2	-3
696	3	10	1	2	2	2	10	10	1	7	-2	-1	-1	-1	7	7	-2
699	5	10	3	2	2	2	10	4	4	5	-2	-3	-3	-3	5	-1	-1
704	1	10	1	1	1	1	10	1	1	9	0	0	0	0	9	0	0
705	1	10	1	1	1	1	10	1	1	9	0	0	0	0	9	0	0
706	1	10	2	1	1	1	10	1	1	9	1	0	0	0	9	0	0
707	4	10	6	1	1	1	10	10	2	6	2	-3	-3	-3	6	6	-2
711	3	10	1	3	3	3	10	10	1	7	-2	0	0	0	7	7	-2
714	2	10	3	1	1	1	10	10	1	8	1	-1	-1	-1	8	8	-1
716	1	10	2	1	1	1	10	4	3	9	1	0	0	0	9	3	2
717	2	10	3	1	1	1	10	10	2	8	1	-1	-1	-1	8	8	0
719	1	10	9	1	1	1	10	1	2	9	8	0	0	0	9	0	1
720	2	10	1	1	2	2	10	1	3	8	-1	-1	0	0	8	-1	1
722	3	10	4	1	1	1	10	10	3	7	1	-2	-2	-2	7	7	0
725	1	10	10	1	1	1	10	10	2	9	9	0	0	0	9	9	1
726	3	10	2	2	2	2	10	3	1	7	-1	-1	-1	-1	7	0	-2
729	2	10	10	1	1	1	10	4	1	8	8	-1	-1	-1	8	2	-1
731	2	8	1	1	1	1	10	1	2	6	-1	-1	-1	-1	8	-1	0
733	2	10	4	2	2	2	10	1	2	8	2	0	0	0	8	-1	0
735	1	10	4	0	0	0	10	10	2	9	3	-1	-1	-1	9	9	1
736	6	10	3	3	3	3	10	6	3	4	-3	-3	-3	-3	4	0	-3
742	1	10	1	1	1	1	10	3	2	9	0	0	0	0	9	2	1
743	1	10	2	1	1	1	10	1	1	9	1	0	0	0	9	0	0
744	1	7	1	0	0	0	10	1	2	6	0	-1	-1	-1	9	0	1
745	2	10	4	1	1	1	10	10	1	8	2	-1	-1	-1	8	8	-1
747	1	9	1	0	0	0	10	1	2	8	0	-1	-1	-1	9	0	1
748	2	10	2	2	2	2	10	2	2	8	0	0	0	0	8	0	0
750	2	10	5	1	1	1	10	10	2	8	3	-1	-1	-1	8	8	0
752	4	10	3	2	2	2	10	10	2	6	-1	-2	-2	-2	6	6	-2
756	1	10	3	1	1	1	10	1	4	9	2	0	0	0	9	0	3
757	2	10	2	1	1	1	10	1	3	8	0	-1	-1	-1	8	-1	1
759	2	10	10	1	1	1	10	4	2	8	8	-1	-1	-1	8	2	0
761	2	10	1	2	2	2	10	1	2	8	-1	0	0	0	8	-1	0
763	2	10	2	2	2	2	10	4	1	8	0	0	0	0	8	2	-1
765	1	10	4	1	1	1	10	1	1	9	3	0	0	0	9	0	0
766	1	10	3	0	0	0	10	4	1	9	2	-1	-1	-1	9	3	0
767	3	10	2	1	1	1	10	1	2	7	-1	-2	-2	-2	7	-2	-1
770	2	10	1	2	2	2	10	2	3	8	-1	0	0	0	8	0	1
772	2	10	3	2	2	2	10	9	3	8	1	0	0	0	8	7	1
774	1	10	10	1	1	1	10	5	2	9	9	0	0	0	9	4	1
775	2	10	6	2	2	2	10	10	2	8	4	0	0	0	8	8	0
777	1	10	10	1	1	1	10	10	3	9	9	0	0	0	9	9	2
778	2	10	10	2	2	2	10	4	2	8	8	0	0	0	8	2	0
780	2	10	3	1	1	1	10	6	3	8	1	-1	-1	-1	8	4	1
782	4	10	2	1	1	1	10	10	3	6	-2	-3	-3	-3	6	6	-1
786	3	10	6	2	3	3	10	10	4	7	3	-1	0	0	7	7	1
789	2	10	1	2	2	2	10	1	1	8	-1	0	0	0	8	-1	-1
791	1	10	1	1	1	1	10	1	2	9	0	0	0	0	9	0	1
792	4	10	1	2	2	2	10	1	2	6	-3	-2	-2	-2	6	-3	-2
796	1	10	1	1	1	1	10	1	4	9	0	0	0	0	9	0	3
797	3	10	6	2	2	2	10	10	4	7	3	-1	-1	-1	7	7	1
800	1	10	10	1	1	1	10	10	1	9	9	0	0	0	9	9	0
801	3	10	2	2	2	2	10	3	2	7	-1	-1	-1	-1	7	0	-1
804	1	10	4	1	1	1	10	6	4	9	3	0	0	0	9	5	3
805	6	10	1	5	5	5	10	1	1	4	-5	-1	-1	-1	4	-5	-5
811	1	10	2	1	1	1	10	2	1	9	1	0	0	0	9	1	0
812	1	10	1	1	1	1	10	2	1	9	0	0	0	0	9	1	0
813	1	10	3	1	1	1	10	1	4	9	2	0	0	0	9	0	3
814	3	10	6	2	2	2	10	10	3	7	3	-1	-1	-1	7	7	0
817	5	10	3	2	2	2	10	10	6	5	-2	-3	-3	-3	5	5	1
822	2	10	2	1	1	1	10	1	2	8	0	-1	-1	-1	8	-1	0
824	5	10	9	2	2	2	10	10	2	5	4	-3	-3	-3	5	5	-3
829	2	10	4	2	2	2	10	10	3	8	2	0	0	0	8	8	1
831	4	10	4	3	3	3	10	10	2	6	0	-1	-1	-1	6	6	-2
835	1	10	1	1	1	1	10	10	1	9	0	0	0	0	9	9	0
836	3	10	1	2	2	2	10	4	1	7	-2	-1	-1	-1	7	1	-2
839	2	10	4	1	1	1	10	2	1	8	2	-1	-1	-1	8	0	-1
841	1	7	1	0	0	0	10	1	2	6	0	-1	-1	-1	9	0	1
842	3	10	3	2	2	2	10	10	3	7	0	-1	-1	-1	7	7	0
845	5	10	3	4	4	4	10	7	2	5	-2	-1	-1	-1	5	2	-3
850	1	10	1	1	1	1	10	10	1	9	0	0	0	0	9	9	0
851	2	10	4	2	2	2	10	5	2	8	2	0	0	0	8	3	0
853	1	10	3	1	1	1	10	3	1	9	2	0	0	0	9	2	0
854	2	10	10	2	2	2	10	6	1	8	8	0	0	0	8	4	-1
856	2	10	2	1	1	1	10	1	2	8	0	-1	-1	-1	8	-1	0
858	2	10	3	2	2	2	10	1	4	8	1	0	0	0	8	-1	2
860	2	10	2	1	2	2	10	1	6	8	0	-1	0	0	8	-1	4
862	5	10	1	3	3	3	10	10	1	5	-4	-2	-2	-2	5	5	-4
867	1	10	1	0	0	0	10	2	5	9	0	-1	-1	-1	9	1	4
868	3	10	1	1	1	1	10	1	3	7	-2	-2	-2	-2	7	-2	0
871	3	10	2	2	2	2	10	10	2	7	-1	-1	-1	-1	7	7	-1
874	2	10	3	2	2	2	10	10	3	8	1	0	0	0	8	8	1
876	3	10	10	3	3	3	10	3	3	7	7	0	0	0	7	0	0
879	1	10	6	1	1	1	10	4	4	9	5	0	0	0	9	3	3
880	1	10	1	1	1	1	10	1	2	9	0	0	0	0	9	0	1
881	1	10	1	0	0	0	10	1	2	9	0	-1	-1	-1	9	0	1
882	3	10	1	2	2	2	10	3	1	7	-2	-1	-1	-1	7	0	-2
885	1	1	1	0	0	0	4	1	3	0	0	-1	-1	-1	3	0	2
886	2	10	3	0	0	0	10	4	4	8	1	-2	-2	-2	8	2	2
888	1	7	1	1	1	1	10	1	2	6	0	0	0	0	9	0	1
889	3	10	1	3	3	3	10	2	2	7	-2	0	0	0	7	-1	-1
892	2	10	4	2	2	2	10	1	5	8	2	0	0	0	8	-1	3
894	2	7	1	0	0	0	7	1	2	5	-1	-2	-2	-2	5	-1	0
896	2	10	6	2	2	2	10	8	3	8	4	0	0	0	8	6	1
898	1	10	2	1	1	1	10	1	3	9	1	0	0	0	9	0	2
899	2	10	1	1	1	1	10	1	2	8	-1	-1	-1	-1	8	-1	0
901	4	10	10	3	4	4	10	10	2	6	6	-1	0	0	6	6	-2
905	1	10	2	1	1	1	10	1	3	9	1	0	0	0	9	0	2
906	3	10	2	2	2	2	10	1	3	7	-1	-1	-1	-1	7	-2	0
909	1	10	1	1	1	1	10	1	5	9	0	0	0	0	9	0	4
910	2	10	3	2	2	2	10	7	1	8	1	0	0	0	8	5	-1
912	3	10	10	1	1	1	10	10	1	7	7	-2	-2	-2	7	7	-2
915	1	10	6	1	1	1	10	4	2	9	5	0	0	0	9	3	1
916	3	10	2	1	1	1	10	1	2	7	-1	-2	-2	-2	7	-2	-1
919	5	10	1	0	0	0	10	1	3	5	-4	-5	-5	-5	5	-4	-2
924	4	10	3	2	2	2	10	10	1	6	-1	-2	-2	-2	6	6	-3
928	2	10	3	2	2	2	10	6	1	8	1	0	0	0	8	4	-1
930	2	10	4	2	2	2	10	4	5	8	2	0	0	0	8	2	3
932	1	10	1	1	1	1	10	3	1	9	0	0	0	0	9	2	0
933	1	10	1	1	1	1	10	1	1	9	0	0	0	0	9	0	0
934	2	10	3	1	1	1	10	1	5	8	1	-1	-1	-1	8	-1	3
936	1	10	3	1	1	1	10	3	1	9	2	0	0	0	9	2	0
937	2	10	6	1	1	1	10	10	3	8	4	-1	-1	-1	8	8	1
939	1	10	3	1	1	1	10	4	1	9	2	0	0	0	9	3	0
940	7	10	10	4	4	4	10	10	2	3	3	-3	-3	-3	3	3	-5
947	4	10	3	2	2	2	10	10	2	6	-1	-2	-2	-2	6	6	-2
951	2	10	9	1	1	1	10	10	3	8	7	-1	-1	-1	8	8	1
953	4	10	1	0	0	0	10	10	2	6	-3	-4	-4	-4	6	6	-2
957	1	10	1	1	1	1	10	1	2	9	0	0	0	0	9	0	1
958	4	10	5	2	2	2	10	10	2	6	1	-2	-2	-2	6	6	-2
962	1	10	10	1	1	1	10	4	3	9	9	0	0	0	9	3	2
963	1	10	1	0	0	0	10	10	4	9	0	-1	-1	-1	9	9	3
964	2	10	1	2	2	2	10	10	1	8	-1	0	0	0	8	8	-1
966	2	10	1	2	2	2	10	10	1	8	-1	0	0	0	8	8	-1
968	7	10	3	5	5	5	10	10	1	3	-4	-2	-2	-2	3	3	-6
975	5	10	9	3	3	3	10	10	2	5	4	-2	-2	-2	5	5	-3
980	1	10	10	1	1	1	10	10	5	9	9	0	0	0	9	9	4
981	1	3	1	1	1	1	10	1	3	2	0	0	0	0	9	0	2
982	1	10	3	1	1	1	10	3	1	9	2	0	0	0	9	2	0
983	1	10	1	1	1	1	10	4	3	9	0	0	0	0	9	3	2
984	1	6	1	1	1	1	10	1	2	5	0	0	0	0	9	0	1
985	7	10	3	5	5	5	10	10	2	3	-4	-2	-2	-2	3	3	-5
992	2	10	3	2	2	2	10	1	2	8	1	0	0	0	8	-1	0
994	3	10	1	0	0	0	10	10	3	7	-2	-3	-3	-3	7	7	0
997	3	10	7	2	2	2	10	10	2	7	4	-1	-1	-1	7	7	-1
1000	3	10	4	2	2	2	10	7	7	7	1	-1	-1	-1	7	4	4
1003	1	3	1	0	0	0	10	1	2	2	0	-1	-1	-1	9	0	1
1004	1	10	2	1	1	1	10	8	1	9	1	0	0	0	9	7	0
1005	1	10	7	1	1	1	10	4	1	9	6	0	0	0	9	3	0
1006	2	10	10	1	1	1	10	10	3	8	8	-1	-1	-1	8	8	1
1008	4	10	2	3	3	3	10	3	2	6	-2	-1	-1	-1	6	-1	-2
1012	2	10	1	2	2	2	10	10	3	8	-1	0	0	0	8	8	1
1014	4	10	1	1	1	1	10	10	2	6	-3	-3	-3	-3	6	6	-2
1018	4	10	1	3	3	3	10	10	1	6	-3	-1	-1	-1	6	6	-3
1022	4	10	1	2	2	2	10	10	2	6	-3	-2	-2	-2	6	6	-2
1026	4	10	1	1	1	1	10	9	7	6	-3	-3	-3	-3	6	5	3
1030	1	10	3	1	1	1	10	9	3	9	2	0	0	0	9	8	2
1031	4	10	6	1	1	1	10	10	4	6	2	-3	-3	-3	6	6	0
1035	2	10	2	1	1	1	10	10	1	8	0	-1	-1	-1	8	8	-1
1037	2	10	2	0	0	0	10	2	2	8	0	-2	-2	-2	8	0	0
1039	2	10	4	2	2	2	10	1	1	8	2	0	0	0	8	-1	-1
1041	3	10	10	3	3	3	10	6	1	7	7	0	0	0	7	3	-2
1044	5	10	2	5	5	5	10	10	2	5	-3	0	0	0	5	5	-3
1049	1	10	5	1	1	1	10	6	2	9	4	0	0	0	9	5	1
1050	1	10	1	1	1	1	10	1	4	9	0	0	0	0	9	0	3
1051	3	10	4	1	1	1	10	10	5	7	1	-2	-2	-2	7	7	2
1054	3	10	2	2	2	2	10	1	1	7	-1	-1	-1	-1	7	-2	-2
1057	1	10	3	0	0	0	10	1	1	9	2	-1	-1	-1	9	0	0
1058	1	10	1	1	1	1	9	10	1	9	0	0	0	0	8	9	0
1059	2	10	1	2	2	2	10	6	1	8	-1	0	0	0	8	4	-1
1061	2	10	10	1	1	1	10	6	5	8	8	-1	-1	-1	8	4	3
1063	4	10	2	1	1	1	10	10	2	6	-2	-3	-3	-3	6	6	-2
1067	3	10	10	3	3	3	10	10	3	7	7	0	0	0	7	7	0
1070	1	7	3	1	1	1	9	1	2	6	2	0	0	0	8	0	1
1071	5	10	6	3	3	3	10	3	4	5	1	-2	-2	-2	5	-2	-1
1076	2	10	1	2	2	2	10	1	3	8	-1	0	0	0	8	-1	1
1078	1	10	10	1	1	1	10	10	1	9	9	0	0	0	9	9	0
1079	1	10	1	1	1	1	10	1	1	9	0	0	0	0	9	0	0
1080	4	10	1	3	3	3	10	7	5	6	-3	-1	-1	-1	6	3	1
1084	1	10	1	0	0	0	10	1	5	9	0	-1	-1	-1	9	0	4
1085	4	10	1	3	3	3	10	9	2	6	-3	-1	-1	-1	6	5	-2
1089	3	10	2	3	3	3	10	10	1	7	-1	0	0	0	7	7	-2
1092	2	10	10	0	0	0	10	10	2	8	8	-2	-2	-2	8	8	0
1094	1	10	6	0	0	0	10	6	1	9	5	-1	-1	-1	9	5	0
1095	4	10	10	0	0	0	10	10	4	6	6	-4	-4	-4	6	6	0
1099	1	10	3	0	0	0	10	10	3	9	2	-1	-1	-1	9	9	2
1100	4	10	3	2	2	2	10	10	3	6	-1	-2	-2	-2	6	6	-1
1104	4	10	1	2	2	2	10	10	1	6	-3	-2	-2	-2	6	6	-3
1108	5	10	10	2	2	2	10	10	1	5	5	-3	-3	-3	5	5	-4
1113	3	10	1	2	2	2	10	1	1	7	-2	-1	-1	-1	7	-2	-2
1116	4	10	7	1	1	1	10	6	2	6	3	-3	-3	-3	6	2	-2
1120	1	10	6	1	1	1	10	10	3	9	5	0	0	0	9	9	2
1121	2	10	2	2	2	2	10	1	2	8	0	0	0	0	8	-1	0
1123	2	10	10	2	2	2	10	1	1	8	8	0	0	0	8	-1	-1
1125	2	10	3	2	2	2	10	10	2	8	1	0	0	0	8	8	0
1127	2	10	3	0	0	0	10	6	1	8	1	-2	-2	-2	8	4	-1
1129	2	10	1	2	2	2	10	1	1	8	-1	0	0	0	8	-1	-1
1131	4	10	3	3	3	3	10	6	1	6	-1	-1	-1	-1	6	2	-3
1135	6	10	4	3	3	3	10	2	3	4	-2	-3	-3	-3	4	-4	-3
1141	2	10	1	2	2	2	10	10	2	8	-1	0	0	0	8	8	0
1143	1	10	1	1	1	1	10	1	1	9	0	0	0	0	9	0	0
1144	1	10	2	1	1	1	10	2	2	9	1	0	0	0	9	1	1
1145	1	10	1	1	1	1	10	1	4	9	0	0	0	0	9	0	3
1146	2	10	1	2	2	2	10	10	2	8	-1	0	0	0	8	8	0
1148	1	10	6	1	1	1	10	4	1	9	5	0	0	0	9	3	0
1149	3	10	10	0	0	0	10	10	3	7	7	-3	-3	-3	7	7	0
1152	1	10	10	1	1	1	10	8	4	9	9	0	0	0	9	7	3
1153	3	7	1	1	1	1	10	1	2	4	-2	-2	-2	-2	7	-2	-1
1156	1	10	1	0	0	0	10	1	1	9	0	-1	-1	-1	9	0	0
1157	3	10	2	1	2	2	10	10	2	7	-1	-2	-1	-1	7	7	-1
1160	2	10	1	0	0	0	10	1	2	8	-1	-2	-2	-2	8	-1	0
1162	1	10	6	1	1	1	10	2	1	9	5	0	0	0	9	1	0
1163	3	10	3	3	3	3	10	10	2	7	0	0	0	0	7	7	-1
1166	1	10	3	0	0	0	10	6	3	9	2	-1	-1	-1	9	5	2
1167	2	10	1	1	1	1	10	1	2	8	-1	-1	-1	-1	8	-1	0
1169	4	10	2	3	3	3	10	10	3	6	-2	-1	-1	-1	6	6	-1
1173	1	10	1	1	1	1	10	1	1	9	0	0	0	0	9	0	0
1174	1	10	2	1	1	1	10	1	1	9	1	0	0	0	9	0	0
1175	3	10	1	2	3	3	10	2	1	7	-2	-1	0	0	7	-1	-2
1178	1	10	2	1	1	1	10	10	5	9	1	0	0	0	9	9	4
1179	1	10	3	1	1	1	10	10	4	9	2	0	0	0	9	9	3
1180	2	10	4	2	2	2	10	4	2	8	2	0	0	0	8	2	0
1182	1	10	6	1	1	1	10	3	2	9	5	0	0	0	9	2	1
1183	1	10	1	1	1	1	10	1	4	9	0	0	0	0	9	0	3
1184	3	10	4	3	3	3	10	2	2	7	1	0	0	0	7	-1	-1
1187	2	10	1	2	2	2	10	10	1	8	-1	0	0	0	8	8	-1
1189	1	10	1	1	1	1	10	1	1	9	0	0	0	0	9	0	0
1190	1	10	2	0	0	0	10	1	5	9	1	-1	-1	-1	9	0	4
1191	3	10	10	2	2	2	10	10	1	7	7	-1	-1	-1	7	7	-2
1194	2	10	5	2	2	2	10	10	1	8	3	0	0	0	8	8	-1
1196	3	10	1	1	1	1	10	10	1	7	-2	-2	-2	-2	7	7	-2
1199	3	10	1	1	1	1	10	1	3	7	-2	-2	-2	-2	7	-2	0
1202	2	10	1	2	2	2	10	10	3	8	-1	0	0	0	8	8	1
1204	1	10	4	1	1	1	10	10	2	9	3	0	0	0	9	9	1
1205	1	10	2	0	0	0	10	1	5	9	1	-1	-1	-1	9	0	4
1206	1	10	10	1	1	1	10	10	1	9	9	0	0	0	9	9	0
1207	1	10	2	1	1	1	10	1	4	9	1	0	0	0	9	0	3
1208	2	10	1	1	1	1	10	3	2	8	-1	-1	-1	-1	8	1	0
1210	3	10	10	2	2	2	10	10	1	7	7	-1	-1	-1	7	7	-2
1213	1	10	3	1	1	1	10	4	1	9	2	0	0	0	9	3	0
1214	2	10	10	1	1	1	10	10	1	8	8	-1	-1	-1	8	8	-1
1216	2	10	6	1	1	1	10	3	8	8	4	-1	-1	-1	8	1	6
1218	4	10	10	2	2	2	10	10	2	6	6	-2	-2	-2	6	6	-2
1222	1	10	2	1	1	1	10	1	2	9	1	0	0	0	9	0	1
1223	2	10	1	2	2	2	10	2	1	8	-1	0	0	0	8	0	-1
1225	1	10	6	1	1	1	10	3	5	9	5	0	0	0	9	2	4
1226	6	10	1	3	3	3	10	1	4	4	-5	-3	-3	-3	4	-5	-2
1232	2	10	2	1	1	1	10	10	4	8	0	-1	-1	-1	8	8	2
1234	2	10	4	1	1	1	10	10	2	8	2	-1	-1	-1	8	8	0
1236	1	10	1	1	1	1	10	1	4	9	0	0	0	0	9	0	3
1237	3	10	1	1	1	1	10	7	1	7	-2	-2	-2	-2	7	4	-2
1240	1	10	2	1	1	1	10	1	1	9	1	0	0	0	9	0	0
1241	4	10	2	3	3	3	10	10	5	6	-2	-1	-1	-1	6	6	1
1245	3	10	8	1	1	1	10	7	1	7	5	-2	-2	-2	7	4	-2
1248	2	10	1	1	1	1	10	2	4	8	-1	-1	-1	-1	8	0	2
1250	3	10	10	1	1	1	10	9	1	7	7	-2	-2	-2	7	6	-2
1253	2	10	6	2	2	2	10	10	2	8	4	0	0	0	8	8	0
1255	2	10	3	2	2	2	10	10	3	8	1	0	0	0	8	8	1
1257	3	10	9	3	3	3	10	10	1	7	6	0	0	0	7	7	-2
1260	3	10	1	1	1	1	10	10	2	7	-2	-2	-2	-2	7	7	-1
1263	3	10	3	0	0	0	10	3	1	7	0	-3	-3	-3	7	0	-2
1266	2	10	10	1	1	1	10	10	4	8	8	-1	-1	-1	8	8	2
1268	1	10	10	1	1	1	10	10	2	9	9	0	0	0	9	9	1
1269	3	10	3	1	1	1	10	2	1	7	0	-2	-2	-2	7	-1	-2
1272	4	10	10	3	3	3	10	10	1	6	6	-1	-1	-1	6	6	-3
1276	3	10	2	1	1	1	10	6	6	7	-1	-2	-2	-2	7	3	3
1279	2	10	3	1	1	1	10	3	2	8	1	-1	-1	-1	8	1	0
1281	3	10	2	1	1	1	10	10	1	7	-1	-2	-2	-2	7	7	-2
1284	3	10	6	0	0	0	10	10	2	7	3	-3	-3	-3	7	7	-1
1287	2	10	10	1	1	1	10	10	2	8	8	-1	-1	-1	8	8	0
1289	5	10	3	2	2	2	10	3	1	5	-2	-3	-3	-3	5	-2	-4
1294	2	10	1	2	2	2	10	2	7	8	-1	0	0	0	8	0	5
1296	2	10	10	1	1	1	10	10	1	8	8	-1	-1	-1	8	8	-1
1298	2	10	4	0	0	0	10	1	4	8	2	-2	-2	-2	8	-1	2
1300	5	10	3	1	1	1	10	10	3	5	-2	-4	-4	-4	5	5	-2
1305	2	10	3	1	1	1	10	9	3	8	1	-1	-1	-1	8	7	1
1307	1	10	3	1	1	1	10	3	2	9	2	0	0	0	9	2	1
1308	2	10	4	1	1	1	10	10	1	8	2	-1	-1	-1	8	8	-1
1310	3	10	3	2	2	2	10	3	4	7	0	-1	-1	-1	7	0	1
1313	2	10	1	1	1	1	10	10	1	8	-1	-1	-1	-1	8	8	-1
1315	2	10	10	0	0	0	10	10	3	8	8	-2	-2	-2	8	8	1
1317	3	10	3	2	2	2	10	10	1	7	0	-1	-1	-1	7	7	-2
1320	2	10	7	2	2	2	10	10	1	8	5	0	0	0	8	8	-1
1322	4	10	10	0	0	0	10	10	1	6	6	-4	-4	-4	6	6	-3
1326	2	10	1	2	2	2	10	10	4	8	-1	0	0	0	8	8	2
1328	2	10	2	2	2	2	10	3	3	8	0	0	0	0	8	1	1
1330	2	10	2	0	0	0	10	10	1	8	0	-2	-2	-2	8	8	-1
1332	1	10	3	1	1	1	10	1	1	9	2	0	0	0	9	0	0
1333	3	10	4	2	2	2	10	1	1	7	1	-1	-1	-1	7	-2	-2
1336	1	10	9	1	1	1	10	10	2	9	8	0	0	0	9	9	1
1337	5	10	6	3	3	3	10	10	2	5	1	-2	-2	-2	5	5	-3
1342	2	10	1	2	2	2	10	1	5	8	-1	0	0	0	8	-1	3
1344	3	10	1	1	1	1	10	10	1	7	-2	-2	-2	-2	7	7	-2
1347	5	10	10	3	3	3	10	10	4	5	5	-2	-2	-2	5	5	-1
1352	1	10	2	1	1	1	10	10	1	9	1	0	0	0	9	9	0
1353	3	10	10	2	2	2	10	10	1	7	7	-1	-1	-1	7	7	-2
1356	1	10	2	1	1	1	10	3	4	9	1	0	0	0	9	2	3
1357	2	10	10	2	2	2	10	10	2	8	8	0	0	0	8	8	0
1359	2	10	10	1	1	1	10	10	3	8	8	-1	-1	-1	8	8	1
1361	2	10	6	0	0	0	10	9	2	8	4	-2	-2	-2	8	7	0
1363	1	10	2	1	1	1	10	1	1	9	1	0	0	0	9	0	0
1364	1	10	1	0	0	0	10	10	4	9	0	-1	-1	-1	9	9	3
1365	1	10	1	1	1	1	10	10	3	9	0	0	0	0	9	9	2
1366	4	10	2	4	4	4	10	3	3	6	-2	0	0	0	6	-1	-1
1370	2	10	3	0	0	0	10	3	4	8	1	-2	-2	-2	8	1	2
1372	3	10	4	3	3	3	10	10	2	7	1	0	0	0	7	7	-1
1375	2	10	1	1	1	1	10	3	1	8	-1	-1	-1	-1	8	1	-1
1377	2	10	1	2	2	2	10	10	1	8	-1	0	0	0	8	8	-1
1379	2	10	1	1	1	1	10	1	1	8	-1	-1	-1	-1	8	-1	-1
1381	3	10	5	2	2	2	10	10	3	7	2	-1	-1	-1	7	7	0
1384	4	10	2	0	0	0	10	10	1	6	-2	-4	-4	-4	6	6	-3
1388	5	10	3	1	1	1	10	10	3	5	-2	-4	-4	-4	5	5	-2
1393	2	10	10	2	2	2	10	10	4	8	8	0	0	0	8	8	2
1395	3	10	2	0	0	0	10	1	2	7	-1	-3	-3	-3	7	-2	-1
1398	1	5	1	0	0	0	6	1	1	4	0	-1	-1	-1	5	0	0
1399	2	10	3	1	1	1	10	5	1	8	1	-1	-1	-1	8	3	-1
1401	1	10	10	1	1	1	10	1	2	9	9	0	0	0	9	0	1
1402	3	10	1	0	0	0	10	7	2	7	-2	-3	-3	-3	7	4	-1
1405	1	10	2	1	1	1	10	1	1	9	1	0	0	0	9	0	0
1406	3	10	1	1	2	2	10	4	2	7	-2	-2	-1	-1	7	1	-1
1409	2	10	10	0	0	0	10	10	1	8	8	-2	-2	-2	8	8	-1
1411	4	10	9	1	1	1	10	10	3	6	5	-3	-3	-3	6	6	-1
1415	5	10	1	4	4	4	10	2	3	5	-4	-1	-1	-1	5	-3	-2
1420	2	10	6	1	1	1	10	10	3	8	4	-1	-1	-1	8	8	1
1422	2	10	10	1	1	1	10	10	3	8	8	-1	-1	-1	8	8	1
1424	4	10	5	3	3	3	10	10	2	6	1	-1	-1	-1	6	6	-2
1428	3	10	5	2	2	2	10	5	4	7	2	-1	-1	-1	7	2	1
1431	1	10	2	1	1	1	10	6	1	9	1	0	0	0	9	5	0
1432	3	10	3	2	2	2	10	10	4	7	0	-1	-1	-1	7	7	1
1435	1	7	1	1	1	1	10	4	2	6	0	0	0	0	9	3	1
1436	3	10	1	2	2	2	10	4	3	7	-2	-1	-1	-1	7	1	0
1439	7	10	7	3	3	3	10	10	4	3	0	-4	-4	-4	3	3	-3
1446	1	10	6	1	1	1	10	1	2	9	5	0	0	0	9	0	1
1447	4	10	6	4	4	4	10	10	1	6	2	0	0	0	6	6	-3
1451	2	10	1	1	1	1	10	10	1	8	-1	-1	-1	-1	8	8	-1
1453	4	10	9	3	3	3	10	10	2	6	5	-1	-1	-1	6	6	-2
1457	3	10	10	2	2	2	10	1	2	7	7	-1	-1	-1	7	-2	-1
1460	2	10	10	1	1	1	10	10	4	8	8	-1	-1	-1	8	8	2
1462	2	10	2	1	1	1	10	3	1	8	0	-1	-1	-1	8	1	-1
1464	1	10	1	1	1	1	10	10	2	9	0	0	0	0	9	9	1
1465	2	10	1	2	2	2	10	1	2	8	-1	0	0	0	8	-1	0
1467	5	10	1	3	3	3	10	10	3	5	-4	-2	-2	-2	5	5	-2
1472	4	10	4	3	3	3	10	10	3	6	0	-1	-1	-1	6	6	-1
1476	2	10	2	2	2	2	10	2	1	8	0	0	0	0	8	0	-1
1478	2	10	2	1	1	1	10	1	1	8	0	-1	-1	-1	8	-1	-1
1480	3	10	4	2	2	2	10	10	1	7	1	-1	-1	-1	7	7	-2
1483	3	10	4	2	2	2	10	6	2	7	1	-1	-1	-1	7	3	-1
1486	3	10	4	1	1	1	10	2	5	7	1	-2	-2	-2	7	-1	2
1489	5	10	2	1	1	1	10	4	1	5	-3	-4	-4	-4	5	-1	-4
1494	2	10	1	2	2	2	10	2	2	8	-1	0	0	0	8	0	0
1496	5	10	10	1	1	1	10	10	2	5	5	-4	-4	-4	5	5	-3
1501	7	10	3	2	2	2	10	10	2	3	-4	-5	-5	-5	3	3	-5
1508	2	10	4	2	2	2	10	10	7	8	2	0	0	0	8	8	5
1510	3	10	10	2	2	2	10	7	4	7	7	-1	-1	-1	7	4	1
1513	1	10	1	1	1	1	10	3	3	9	0	0	0	0	9	2	2
1514	3	10	10	1	1	1	10	10	2	7	7	-2	-2	-2	7	7	-1
1517	5	10	1	3	3	3	10	4	4	5	-4	-2	-2	-2	5	-1	-1
1522	1	10	2	0	0	0	10	1	3	9	1	-1	-1	-1	9	0	2
1523	3	10	2	2	2	2	10	1	4	7	-1	-1	-1	-1	7	-2	1
1526	1	10	4	1	1	1	10	5	2	9	3	0	0	0	9	4	1
1527	2	10	10	1	1	1	10	7	2	8	8	-1	-1	-1	8	5	0
1529	4	10	2	0	0	0	10	10	1	6	-2	-4	-4	-4	6	6	-3
1533	1	10	4	0	0	0	10	10	2	9	3	-1	-1	-1	9	9	1
1534	3	10	10	2	2	2	10	10	2	7	7	-1	-1	-1	7	7	-1
1537	2	10	3	2	2	2	10	4	2	8	1	0	0	0	8	2	0
1539	2	10	3	1	1	1	10	10	2	8	1	-1	-1	-1	8	8	0
1541	1	7	1	0	0	0	10	1	1	6	0	-1	-1	-1	9	0	0
1542	3	10	5	1	1	1	10	10	5	7	2	-2	-2	-2	7	7	2
1545	2	10	1	2	2	2	10	10	1	8	-1	0	0	0	8	8	-1
1547	2	10	2	1	1	1	10	10	1	8	0	-1	-1	-1	8	8	-1
1549	1	9	1	0	0	0	10	1	2	8	0	-1	-1	-1	9	0	1
1550	3	10	10	1	1	1	10	10	2	7	7	-2	-2	-2	7	7	-1
1553	3	10	2	1	1	1	10	1	3	7	-1	-2	-2	-2	7	-2	0
1556	2	10	2	1	1	1	10	1	2	8	0	-1	-1	-1	8	-1	0
1558	8	10	6	5	5	5	10	1	2	2	-2	-3	-3	-3	2	-7	-6
1566	2	10	1	0	0	0	10	1	5	8	-1	-2	-2	-2	8	-1	3
1568	4	10	2	1	1	1	10	10	2	6	-2	-3	-3	-3	6	6	-2
1572	2	10	6	2	2	2	10	6	3	8	4	0	0	0	8	4	1
1574	1	10	1	1	1	1	10	2	3	9	0	0	0	0	9	1	2
1575	3	10	1	2	2	2	10	6	2	7	-2	-1	-1	-1	7	3	-1
1578	5	10	1	5	5	5	10	10	1	5	-4	0	0	0	5	5	-4
1583	7	10	4	5	5	5	10	3	3	3	-3	-2	-2	-2	3	-4	-4
1590	1	10	10	1	1	1	10	10	3	9	9	0	0	0	9	9	2
1591	3	10	5	1	1	1	10	10	1	7	2	-2	-2	-2	7	7	-2
1594	5	10	3	3	3	3	10	10	1	5	-2	-2	-2	-2	5	5	-4
1599	3	10	6	3	3	3	10	10	2	7	3	0	0	0	7	7	-1
1602	2	10	1	0	0	0	10	1	2	8	-1	-2	-2	-2	8	-1	0
1604	3	10	1	2	2	2	10	10	2	7	-2	-1	-1	-1	7	7	-1
1607	1	8	1	1	1	1	10	7	1	7	0	0	0	0	9	6	0
1608	2	10	6	0	0	0	10	3	2	8	4	-2	-2	-2	8	1	0
1610	3	10	3	2	2	2	10	4	3	7	0	-1	-1	-1	7	1	0
1613	3	10	2	2	2	2	10	10	4	7	-1	-1	-1	-1	7	7	1
1616	2	10	3	1	1	1	10	10	3	8	1	-1	-1	-1	8	8	1
1618	1	10	10	1	1	1	10	3	3	9	9	0	0	0	9	2	2
1619	1	10	2	0	0	0	10	8	2	9	1	-1	-1	-1	9	7	1
1620	7	10	10	2	2	2	10	10	2	3	3	-5	-5	-5	3	3	-5
1627	2	10	10	2	2	2	10	10	1	8	8	0	0	0	8	8	-1
1629	8	10	9	2	2	2	10	10	4	2	1	-6	-6	-6	2	2	-4
1637	1	10	6	1	1	1	10	8	2	9	5	0	0	0	9	7	1
1638	2	10	10	0	0	0	10	10	1	8	8	-2	-2	-2	8	8	-1
1640	2	10	3	1	1	1	10	1	2	8	1	-1	-1	-1	8	-1	0
1642	4	10	2	2	2	2	10	3	2	6	-2	-2	-2	-2	6	-1	-2
1646	3	10	1	1	1	1	10	10	2	7	-2	-2	-2	-2	7	7	-1
1649	5	10	1	3	3	3	10	10	1	5	-4	-2	-2	-2	5	5	-4
1654	4	10	6	3	3	3	10	10	3	6	2	-1	-1	-1	6	6	-1
1658	4	10	6	2	2	2	10	10	1	6	2	-2	-2	-2	6	6	-3
1662	2	10	10	2	2	2	10	5	3	8	8	0	0	0	8	3	1
1664	4	10	3	1	1	1	10	2	4	6	-1	-3	-3	-3	6	-2	0
1668	3	10	6	2	2	2	10	2	2	7	3	-1	-1	-1	7	-1	-1
1671	1	10	1	1	1	1	10	1	3	9	0	0	0	0	9	0	2
1672	4	10	1	4	4	4	10	2	3	6	-3	0	0	0	6	-2	-1
1676	5	10	2	4	3	3	10	6	1	5	-3	-1	-2	-2	5	1	-4
1681	2	10	10	1	1	1	10	10	4	8	8	-1	-1	-1	8	8	2
1683	2	10	10	1	1	1	10	10	1	8	8	-1	-1	-1	8	8	-1
1685	2	10	1	1	1	1	10	10	1	8	-1	-1	-1	-1	8	8	-1
1687	1	10	1	1	1	1	10	1	1	9	0	0	0	0	9	0	0
1688	3	10	6	3	3	3	10	10	1	7	3	0	0	0	7	7	-2
1691	3	10	8	3	3	3	10	1	2	7	5	0	0	0	7	-2	-1
1694	4	10	4	2	2	2	10	10	4	6	0	-2	-2	-2	6	6	0
1698	4	10	1	4	4	4	10	10	2	6	-3	0	0	0	6	6	-2
1702	3	10	3	3	3	3	10	10	4	7	0	0	0	0	7	7	1
1705	3	10	1	1	1	1	10	1	2	7	-2	-2	-2	-2	7	-2	-1
1708	3	10	10	2	2	2	10	10	2	7	7	-1	-1	-1	7	7	-1
1711	1	10	1	1	1	1	10	10	1	9	0	0	0	0	9	9	0
1712	2	10	2	2	2	2	10	6	1	8	0	0	0	0	8	4	-1
1714	4	10	1	2	2	2	10	10	1	6	-3	-2	-2	-2	6	6	-3
1718	6	10	1	3	3	3	10	10	4	4	-5	-3	-3	-3	4	4	-2
1724	3	10	6	1	1	1	10	10	4	7	3	-2	-2	-2	7	7	1
1727	2	10	5	2	2	2	10	10	4	8	3	0	0	0	8	8	2
1729	1	10	1	1	1	1	10	2	1	9	0	0	0	0	9	1	0
1730	1	10	3	0	0	0	10	2	2	9	2	-1	-1	-1	9	1	1
1731	6	10	3	0	0	0	10	10	3	4	-3	-6	-6	-6	4	4	-3
1737	3	10	2	3	3	3	10	1	2	7	-1	0	0	0	7	-2	-1
1740	10	10	8	3	3	3	10	10	1	0	-2	-7	-7	-7	0	0	-9
1750	5	10	10	4	4	4	10	10	5	5	5	-1	-1	-1	5	5	0
1755	1	10	1	1	1	1	10	6	6	9	0	0	0	0	9	5	5
1756	8	10	10	4	4	4	10	10	1	2	2	-4	-4	-4	2	2	-7
1764	5	10	10	2	3	3	10	10	1	5	5	-3	-2	-2	5	5	-4
1769	1	10	10	0	0	0	10	10	1	9	9	-1	-1	-1	9	9	0
1770	1	10	9	1	1	1	10	7	5	9	8	0	0	0	9	6	4
1771	4	10	10	2	2	2	10	9	3	6	6	-2	-2	-2	6	5	-1
1775	3	10	10	3	3	3	10	10	4	7	7	0	0	0	7	7	1
1778	2	10	10	2	2	2	10	10	2	8	8	0	0	0	8	8	0
1780	3	10	10	2	2	2	10	10	1	7	7	-1	-1	-1	7	7	-2
1783	3	10	1	2	2	2	10	1	2	7	-2	-1	-1	-1	7	-2	-1
1786	1	10	2	1	1	1	10	4	2	9	1	0	0	0	9	3	1
1787	3	10	1	1	1	1	10	3	2	7	-2	-2	-2	-2	7	0	-1
1790	4	10	10	4	4	4	10	10	3	6	6	0	0	0	6	6	-1
1794	1	10	10	1	1	1	10	10	1	9	9	0	0	0	9	9	0
1795	1	10	10	0	0	0	10	10	3	9	9	-1	-1	-1	9	9	2
1796	3	10	10	2	2	2	10	10	1	7	7	-1	-1	-1	7	7	-2
1799	2	10	5	1	1	1	10	10	1	8	3	-1	-1	-1	8	8	-1
1801	2	10	3	0	0	0	10	6	1	8	1	-2	-2	-2	8	4	-1
1803	3	10	6	2	2	2	10	10	1	7	3	-1	-1	-1	7	7	-2
1806	2	10	10	1	1	1	10	10	3	8	8	-1	-1	-1	8	8	1
1808	3	10	1	2	2	2	10	10	1	7	-2	-1	-1	-1	7	7	-2
1811	3	10	1	3	3	3	10	6	1	7	-2	0	0	0	7	3	-2
1814	2	10	2	0	0	0	10	10	1	8	0	-2	-2	-2	8	8	-1
1816	4	10	10	1	1	1	10	10	4	6	6	-3	-3	-3	6	6	0
1820	2	10	10	1	1	1	10	10	4	8	8	-1	-1	-1	8	8	2
1822	7	10	6	6	6	6	10	10	8	3	-1	-1	-1	-1	3	3	1
1829	1	10	6	1	1	1	10	10	2	9	5	0	0	0	9	9	1
1830	1	10	10	1	1	1	10	4	2	9	9	0	0	0	9	3	1
1831	1	10	1	1	1	1	10	1	1	9	0	0	0	0	9	0	0
1832	1	10	10	0	0	0	10	4	2	9	9	-1	-1	-1	9	3	1
1833	5	10	1	2	2	2	10	10	1	5	-4	-3	-3	-3	5	5	-4
1838	1	10	1	1	1	1	10	1	2	9	0	0	0	0	9	0	1
1839	4	10	1	2	2	2	10	10	1	6	-3	-2	-2	-2	6	6	-3
1843	1	10	1	1	1	1	10	2	2	9	0	0	0	0	9	1	1
1844	1	0	0	0	0	0	10	1	1	-1	-1	-1	-1	-1	9	0	0
1845	5	10	4	1	1	1	10	10	3	5	-1	-4	-4	-4	5	5	-2
1850	2	10	10	1	1	1	10	9	2	8	8	-1	-1	-1	8	7	0
1852	6	10	3	4	4	4	10	10	1	4	-3	-2	-2	-2	4	4	-5
1858	1	10	10	1	1	1	10	9	3	9	9	0	0	0	9	8	2
1859	1	10	3	1	1	1	10	1	2	9	2	0	0	0	9	0	1
1860	3	10	4	0	0	0	10	10	3	7	1	-3	-3	-3	7	7	0
1863	2	10	10	1	1	1	10	10	3	8	8	-1	-1	-1	8	8	1
1865	1	10	1	1	1	1	10	10	2	9	0	0	0	0	9	9	1
1866	1	10	8	0	0	0	10	4	1	9	7	-1	-1	-1	9	3	0
1867	2	10	10	1	1	1	10	10	4	8	8	-1	-1	-1	8	8	2
1869	2	10	10	2	2	2	10	10	2	8	8	0	0	0	8	8	0
1871	4	10	3	1	1	1	10	10	3	6	-1	-3	-3	-3	6	6	-1
1875	2	10	1	1	1	1	10	10	4	8	-1	-1	-1	-1	8	8	2
1877	3	10	2	2	2	2	10	4	1	7	-1	-1	-1	-1	7	1	-2
1880	1	10	10	1	1	1	10	9	1	9	9	0	0	0	9	8	0
1881	4	10	10	3	3	3	10	10	1	6	6	-1	-1	-1	6	6	-3
1885	1	10	1	1	1	1	10	1	1	9	0	0	0	0	9	0	0
1886	2	10	1	2	2	2	10	3	1	8	-1	0	0	0	8	1	-1
1888	2	10	4	1	1	1	10	2	3	8	2	-1	-1	-1	8	0	1
1890	3	10	10	3	2	2	10	3	3	7	7	0	-1	-1	7	0	0
1893	5	10	9	3	3	3	10	10	2	5	4	-2	-2	-2	5	5	-3
1898	3	10	3	2	2	2	10	10	1	7	0	-1	-1	-1	7	7	-2
1901	3	10	10	3	3	3	10	10	1	7	7	0	0	0	7	7	-2
1904	2	10	2	1	1	1	10	10	5	8	0	-1	-1	-1	8	8	3
1906	3	10	1	1	1	1	10	10	2	7	-2	-2	-2	-2	7	7	-1
1909	3	10	3	2	2	2	10	10	4	7	0	-1	-1	-1	7	7	1
1912	1	10	10	1	1	1	10	10	1	9	9	0	0	0	9	9	0
1913	1	10	2	1	1	1	10	1	2	9	1	0	0	0	9	0	1
1914	1	10	3	1	1	1	10	10	1	9	2	0	0	0	9	9	0
1915	1	10	1	0	0	0	10	1	4	9	0	-1	-1	-1	9	0	3
1916	2	10	1	0	0	0	10	2	1	8	-1	-2	-2	-2	8	0	-1
1918	1	10	10	1	1	1	10	9	1	9	9	0	0	0	9	8	0
1919	1	10	2	1	1	1	10	1	1	9	1	0	0	0	9	0	0
1920	1	10	2	1	1	1	10	3	3	9	1	0	0	0	9	2	2
1921	1	10	2	1	1	1	10	1	4	9	1	0	0	0	9	0	3
1922	1	10	1	1	1	1	10	1	3	9	0	0	0	0	9	0	2
1923	1	10	2	1	1	1	10	1	2	9	1	0	0	0	9	0	1
1924	2	10	2	1	1	1	10	2	2	8	0	-1	-1	-1	8	0	0
1926	1	3	1	0	0	0	4	1	2	2	0	-1	-1	-1	3	0	1
1927	1	10	2	1	1	1	10	1	3	9	1	0	0	0	9	0	2
1928	2	10	2	2	2	2	10	1	4	8	0	0	0	0	8	-1	2
1930	1	3	1	0	0	0	10	1	2	2	0	-1	-1	-1	9	0	1
1931	3	10	2	3	3	3	10	1	3	7	-1	0	0	0	7	-2	0
1934	1	10	4	0	0	0	10	8	1	9	3	-1	-1	-1	9	7	0
1935	4	10	1	3	3	3	10	10	2	6	-3	-1	-1	-1	6	6	-2
1939	2	10	10	2	2	2	10	6	2	8	8	0	0	0	8	4	0
1941	2	10	10	1	1	1	10	10	1	8	8	-1	-1	-1	8	8	-1
1943	2	10	1	0	0	0	10	10	1	8	-1	-2	-2	-2	8	8	-1
1945	5	10	2	3	3	3	10	10	3	5	-3	-2	-2	-2	5	5	-2
1950	1	10	1	1	1	1	10	9	1	9	0	0	0	0	9	8	0
1951	3	10	4	3	3	3	10	4	1	7	1	0	0	0	7	1	-2
1954	1	10	1	1	1	1	10	1	3	9	0	0	0	0	9	0	2
1955	1	10	1	1	1	1	10	2	1	9	0	0	0	0	9	1	0
1956	3	6	1	2	2	2	10	1	1	3	-2	-1	-1	-1	7	-2	-2
1959	1	10	10	1	1	1	10	5	1	9	9	0	0	0	9	4	0
1960	1	10	10	1	1	1	10	9	1	9	9	0	0	0	9	8	0
1961	2	10	6	2	2	2	10	8	1	8	4	0	0	0	8	6	-1
1963	2	10	1	2	2	2	10	10	1	8	-1	0	0	0	8	8	-1
1965	3	10	10	1	1	1	10	10	2	7	7	-2	-2	-2	7	7	-1
1968	3	10	1	3	3	3	10	7	1	7	-2	0	0	0	7	4	-2
1971	1	10	10	1	1	1	10	10	3	9	9	0	0	0	9	9	2
1972	4	10	6	0	0	0	10	10	6	6	2	-4	-4	-4	6	6	2
1976	1	10	10	1	1	1	10	3	2	9	9	0	0	0	9	2	1
1977	2	10	10	2	2	2	10	2	2	8	8	0	0	0	8	0	0
1979	3	10	10	2	2	2	10	10	1	7	7	-1	-1	-1	7	7	-2
1982	2	10	10	2	2	2	10	6	4	8	8	0	0	0	8	4	2
1984	3	10	1	1	1	1	10	6	2	7	-2	-2	-2	-2	7	3	-1
1987	8	10	7	2	2	2	10	10	4	2	-1	-6	-6	-6	2	2	-4
1995	1	10	6	1	1	1	10	3	1	9	5	0	0	0	9	2	0
1996	3	10	4	3	3	3	10	10	3	7	1	0	0	0	7	7	0
1999	4	10	2	1	1	1	10	1	3	6	-2	-3	-3	-3	6	-3	-1
2003	1	0	0	0	0	0	10	10	4	-1	-1	-1	-1	-1	9	9	3
2004	5	10	1	2	2	2	10	10	3	5	-4	-3	-3	-3	5	5	-2
2009	1	10	10	1	1	1	10	10	1	9	9	0	0	0	9	9	0
2010	4	10	6	4	4	4	10	3	1	6	2	0	0	0	6	-1	-3
2014	1	10	1	0	0	0	10	1	3	9	0	-1	-1	-1	9	0	2
2015	1	10	3	1	1	1	10	1	7	9	2	0	0	0	9	0	6
2016	9	10	4	4	4	4	10	10	1	1	-5	-5	-5	-5	1	1	-8
2025	2	10	2	1	1	1	10	2	2	8	0	-1	-1	-1	8	0	0
2027	1	10	2	1	1	1	10	3	1	9	1	0	0	0	9	2	0
2028	2	10	3	1	1	1	10	10	1	8	1	-1	-1	-1	8	8	-1
2030	3	10	4	2	2	2	10	1	3	7	1	-1	-1	-1	7	-2	0
2033	4	10	1	3	3	3	10	10	2	6	-3	-1	-1	-1	6	6	-2
2037	1	10	3	0	0	0	10	9	3	9	2	-1	-1	-1	9	8	2
2038	1	10	10	0	0	0	10	10	4	9	9	-1	-1	-1	9	9	3
2039	1	10	4	1	1	1	10	6	1	9	3	0	0	0	9	5	0
2040	3	6	1	0	0	0	10	1	1	3	-2	-3	-3	-3	7	-2	-2
2043	1	10	3	1	1	1	10	2	3	9	2	0	0	0	9	1	2
2044	3	10	9	2	2	2	10	8	1	7	6	-1	-1	-1	7	5	-2
2047	1	10	5	0	0	0	10	10	3	9	4	-1	-1	-1	9	9	2
2048	1	10	1	1	1	1	10	10	2	9	0	0	0	0	9	9	1
2049	1	10	10	0	0	0	10	10	2	9	9	-1	-1	-1	9	9	1
2050	1	10	1	0	0	0	10	10	3	9	0	-1	-1	-1	9	9	2
2051	2	10	3	1	1	1	10	3	2	8	1	-1	-1	-1	8	1	0
2053	3	10	4	2	2	2	10	6	1	7	1	-1	-1	-1	7	3	-2
2056	4	10	6	3	3	3	10	10	2	6	2	-1	-1	-1	6	6	-2
2060	2	10	10	0	0	0	10	10	1	8	8	-2	-2	-2	8	8	-1
2062	2	10	10	0	0	0	10	10	1	8	8	-2	-2	-2	8	8	-1
2064	1	10	10	1	1	1	10	10	1	9	9	0	0	0	9	9	0
2065	3	10	10	2	2	2	10	10	2	7	7	-1	-1	-1	7	7	-1
2068	2	10	1	2	2	2	10	10	2	8	-1	0	0	0	8	8	0
2070	1	6	2	0	0	0	10	1	3	5	1	-1	-1	-1	9	0	2
2071	1	10	1	1	1	1	10	4	2	9	0	0	0	0	9	3	1
2072	1	10	10	1	1	1	10	3	1	9	9	0	0	0	9	2	0
2073	1	10	2	0	0	0	10	10	3	9	1	-1	-1	-1	9	9	2
2074	1	10	10	1	1	1	10	8	1	9	9	0	0	0	9	7	0
2075	6	10	2	2	2	2	10	1	2	4	-4	-4	-4	-4	4	-5	-4
2081	4	10	1	2	2	2	10	2	3	6	-3	-2	-2	-2	6	-2	-1
2085	1	10	10	1	1	1	10	10	6	9	9	0	0	0	9	9	5
2086	5	10	2	4	4	4	10	10	2	5	-3	-1	-1	-1	5	5	-3
2091	1	10	1	0	0	0	10	1	2	9	0	-1	-1	-1	9	0	1
2092	1	10	2	1	1	1	10	10	4	9	1	0	0	0	9	9	3
2093	2	10	2	0	0	0	10	10	2	8	0	-2	-2	-2	8	8	0
2095	4	10	10	2	3	3	10	10	1	6	6	-2	-1	-1	6	6	-3
2099	1	10	1	0	0	0	10	4	2	9	0	-1	-1	-1	9	3	1
2100	2	10	1	1	1	1	10	3	2	8	-1	-1	-1	-1	8	1	0
2102	2	10	4	2	2	2	10	10	4	8	2	0	0	0	8	8	2
2104	1	10	3	0	0	0	10	4	3	9	2	-1	-1	-1	9	3	2
2105	1	10	10	0	0	0	10	10	2	9	9	-1	-1	-1	9	9	1
2106	4	10	4	2	2	2	10	2	2	6	0	-2	-2	-2	6	-2	-2
2110	2	10	2	0	0	0	10	1	3	8	0	-2	-2	-2	8	-1	1
2112	2	10	3	1	1	1	10	10	1	8	1	-1	-1	-1	8	8	-1
2114	2	10	1	1	1	1	10	1	2	8	-1	-1	-1	-1	8	-1	0
2116	1	10	10	1	1	1	10	10	2	9	9	0	0	0	9	9	1
2117	2	10	10	1	1	1	10	10	2	8	8	-1	-1	-1	8	8	0
2119	2	10	3	2	2	2	10	1	1	8	1	0	0	0	8	-1	-1
2121	1	3	1	0	0	0	9	1	4	2	0	-1	-1	-1	8	0	3
2122	2	10	10	1	1	1	10	10	2	8	8	-1	-1	-1	8	8	0
2124	2	10	1	1	1	1	10	1	1	8	-1	-1	-1	-1	8	-1	-1
2126	1	4	1	1	1	1	9	1	1	3	0	0	0	0	8	0	0
2127	1	10	10	1	1	1	10	10	2	9	9	0	0	0	9	9	1
2128	2	10	3	2	2	2	10	5	1	8	1	0	0	0	8	3	-1
2130	1	10	2	1	1	1	10	7	1	9	1	0	0	0	9	6	0
2131	2	7	1	1	1	1	10	1	2	5	-1	-1	-1	-1	8	-1	0
2133	1	10	3	1	1	1	10	9	1	9	2	0	0	0	9	8	0
2134	1	0	0	0	0	0	0	0	4	-1	-1	-1	-1	-1	-1	-1	3
2135	2	10	10	1	1	1	10	10	1	8	8	-1	-1	-1	8	8	-1
2137	1	10	3	0	0	0	10	3	3	9	2	-1	-1	-1	9	2	2
2138	1	3	1	1	1	1	3	1	2	2	0	0	0	0	2	0	1
2139	3	10	1	1	1	1	10	10	2	7	-2	-2	-2	-2	7	7	-1
2142	3	10	3	2	2	2	10	10	1	7	0	-1	-1	-1	7	7	-2
2145	2	10	10	2	2	2	10	10	4	8	8	0	0	0	8	8	2
2147	2	10	1	2	2	2	10	1	6	8	-1	0	0	0	8	-1	4
2149	1	10	1	1	1	1	10	1	5	9	0	0	0	0	9	0	4
2150	1	10	4	1	1	1	10	10	7	9	3	0	0	0	9	9	6
2151	1	10	3	0	0	0	10	10	2	9	2	-1	-1	-1	9	9	1
2152	2	10	1	1	1	1	10	1	1	8	-1	-1	-1	-1	8	-1	-1
2154	1	10	1	1	1	1	10	6	1	9	0	0	0	0	9	5	0
2155	3	10	10	3	3	3	10	2	1	7	7	0	0	0	7	-1	-2
2158	2	10	5	2	2	2	10	1	1	8	3	0	0	0	8	-1	-1
2160	3	10	6	1	1	1	10	10	2	7	3	-2	-2	-2	7	7	-1
2163	2	10	10	1	1	1	10	10	1	8	8	-1	-1	-1	8	8	-1
2165	1	10	10	1	1	1	10	10	3	9	9	0	0	0	9	9	2
2166	2	10	3	2	2	2	10	1	2	8	1	0	0	0	8	-1	0
2168	1	5	1	1	1	1	6	1	4	4	0	0	0	0	5	0	3
2169	1	10	1	1	1	1	10	10	3	9	0	0	0	0	9	9	2
2170	2	10	1	1	1	1	10	1	4	8	-1	-1	-1	-1	8	-1	2
2172	3	10	1	0	0	0	10	6	3	7	-2	-3	-3	-3	7	3	0
2175	2	10	2	2	2	2	10	3	2	8	0	0	0	0	8	1	0
2177	3	10	2	1	1	1	10	1	2	7	-1	-2	-2	-2	7	-2	-1
2180	1	10	3	1	1	1	10	10	1	9	2	0	0	0	9	9	0
2181	2	10	10	0	0	0	10	10	2	8	8	-2	-2	-2	8	8	0
2183	1	10	4	1	1	1	10	5	1	9	3	0	0	0	9	4	0
2184	3	10	1	1	1	1	10	10	1	7	-2	-2	-2	-2	7	7	-2
2187	2	10	1	2	2	2	10	4	1	8	-1	0	0	0	8	2	-1
2189	1	10	1	1	1	1	10	1	2	9	0	0	0	0	9	0	1
2190	4	10	3	4	4	4	10	10	1	6	-1	0	0	0	6	6	-3
2194	3	10	10	2	2	2	10	10	2	7	7	-1	-1	-1	7	7	-1
2197	1	10	6	0	0	0	10	10	3	9	5	-1	-1	-1	9	9	2
2198	2	10	10	2	2	2	10	10	1	8	8	0	0	0	8	8	-1
2200	3	10	1	3	3	3	10	10	1	7	-2	0	0	0	7	7	-2
2203	1	7	1	1	1	1	10	1	2	6	0	0	0	0	9	0	1
2204	1	10	2	0	0	0	10	10	1	9	1	-1	-1	-1	9	9	0
2205	2	10	2	2	2	2	10	9	3	8	0	0	0	0	8	7	1
2207	3	10	9	3	3	3	10	10	1	7	6	0	0	0	7	7	-2
2210	1	10	3	1	1	1	10	1	4	9	2	0	0	0	9	0	3
2211	1	10	2	1	1	1	10	1	2	9	1	0	0	0	9	0	1
2212	5	10	6	5	5	5	10	10	1	5	1	0	0	0	5	5	-4
2217	2	10	1	2	2	2	10	10	1	8	-1	0	0	0	8	8	-1
2219	1	10	10	0	0	0	10	10	2	9	9	-1	-1	-1	9	9	1
2220	1	10	1	1	1	1	10	1	1	9	0	0	0	0	9	0	0
2221	5	10	1	3	3	3	10	1	4	5	-4	-2	-2	-2	5	-4	-1
2226	3	10	6	1	1	1	10	10	5	7	3	-2	-2	-2	7	7	2
2229	2	10	1	0	0	0	10	1	4	8	-1	-2	-2	-2	8	-1	2
2231	2	10	2	2	2	2	10	3	3	8	0	0	0	0	8	1	1
2233	1	10	1	1	1	1	10	3	2	9	0	0	0	0	9	2	1
2234	2	10	2	2	2	2	10	1	1	8	0	0	0	0	8	-1	-1
2236	3	10	5	3	3	3	10	7	3	7	2	0	0	0	7	4	0
2239	1	10	10	0	0	0	10	10	1	9	9	-1	-1	-1	9	9	0
2240	1	10	3	1	1	1	10	2	3	9	2	0	0	0	9	1	2
2241	2	10	3	2	2	2	10	3	1	8	1	0	0	0	8	1	-1
2243	3	10	10	3	3	3	10	9	3	7	7	0	0	0	7	6	0
2246	2	10	3	1	1	1	10	10	2	8	1	-1	-1	-1	8	8	0
2248	4	10	2	3	3	3	10	7	1	6	-2	-1	-1	-1	6	3	-3
2252	2	10	3	1	1	1	10	10	2	8	1	-1	-1	-1	8	8	0
2254	3	10	3	0	0	0	10	10	3	7	0	-3	-3	-3	7	7	0
2257	1	10	4	1	1	1	10	5	1	9	3	0	0	0	9	4	0
2258	2	10	3	2	2	2	10	3	2	8	1	0	0	0	8	1	0
2260	1	10	3	1	1	1	10	2	2	9	2	0	0	0	9	1	1
2261	3	10	10	1	1	1	10	10	2	7	7	-2	-2	-2	7	7	-1
2264	2	10	2	2	2	2	10	1	3	8	0	0	0	0	8	-1	1
2266	2	10	2	1	1	1	10	10	1	8	0	-1	-1	-1	8	8	-1
2268	1	0	0	0	0	0	2	2	2	-1	-1	-1	-1	-1	1	1	1
2269	2	10	10	2	2	2	10	10	1	8	8	0	0	0	8	8	-1
2271	4	10	2	4	4	4	10	1	3	6	-2	0	0	0	6	-3	-1
2275	2	10	10	2	2	2	10	9	2	8	8	0	0	0	8	7	0
2277	2	10	10	2	2	2	10	10	3	8	8	0	0	0	8	8	1
2279	3	10	6	2	2	2	10	10	1	7	3	-1	-1	-1	7	7	-2
2282	1	10	1	0	0	0	10	1	1	9	0	-1	-1	-1	9	0	0
2283	3	10	1	1	2	2	10	1	1	7	-2	-2	-1	-1	7	-2	-2
2286	1	3	1	0	0	0	10	2	2	2	0	-1	-1	-1	9	1	1
2287	4	10	2	3	3	3	10	6	4	6	-2	-1	-1	-1	6	2	0
2291	4	10	10	0	0	0	10	10	4	6	6	-4	-4	-4	6	6	0
2295	3	10	1	1	1	1	10	2	3	7	-2	-2	-2	-2	7	-1	0
2298	3	10	10	0	0	0	10	10	3	7	7	-3	-3	-3	7	7	0
2301	1	10	1	1	1	1	10	3	3	9	0	0	0	0	9	2	2
2302	5	10	9	4	4	4	10	10	2	5	4	-1	-1	-1	5	5	-3
2307	3	10	2	1	1	1	10	3	1	7	-1	-2	-2	-2	7	0	-2
2310	2	10	1	2	2	2	10	10	1	8	-1	0	0	0	8	8	-1
2312	1	10	2	0	0	0	10	1	1	9	1	-1	-1	-1	9	0	0
2313	2	10	3	2	2	2	10	3	1	8	1	0	0	0	8	1	-1
2315	1	10	2	0	0	0	10	10	3	9	1	-1	-1	-1	9	9	2
2316	2	10	4	0	0	0	10	3	1	8	2	-2	-2	-2	8	1	-1
2318	1	10	6	0	0	0	10	1	2	9	5	-1	-1	-1	9	0	1
2319	3	10	10	2	2	2	10	10	3	7	7	-1	-1	-1	7	7	0
2322	2	10	10	1	1	1	10	10	2	8	8	-1	-1	-1	8	8	0
2324	1	10	10	1	1	1	10	10	3	9	9	0	0	0	9	9	2
2325	4	10	4	1	1	1	10	10	1	6	0	-3	-3	-3	6	6	-3
2329	1	10	10	1	1	1	10	10	1	9	9	0	0	0	9	9	0
2330	3	10	1	1	1	1	10	2	3	7	-2	-2	-2	-2	7	-1	0
2333	2	10	1	1	2	2	10	10	5	8	-1	-1	0	0	8	8	3
2335	2	10	1	1	1	1	10	3	2	8	-1	-1	-1	-1	8	1	0
2337	2	10	3	1	1	1	10	10	1	8	1	-1	-1	-1	8	8	-1
2339	1	4	1	0	0	0	10	6	1	3	0	-1	-1	-1	9	5	0
2340	2	10	6	2	2	2	10	10	2	8	4	0	0	0	8	8	0
2342	1	0	0	0	0	0	10	3	2	-1	-1	-1	-1	-1	9	2	1
2343	2	10	6	2	2	2	10	10	1	8	4	0	0	0	8	8	-1
2345	2	10	4	2	2	2	10	10	1	8	2	0	0	0	8	8	-1
2347	2	10	3	1	1	1	10	1	3	8	1	-1	-1	-1	8	-1	1
2349	2	10	3	2	2	2	10	10	4	8	1	0	0	0	8	8	2
2351	6	10	10	2	2	2	10	10	2	4	4	-4	-4	-4	4	4	-4
2357	3	10	4	3	3	3	10	3	4	7	1	0	0	0	7	0	1
2360	2	10	1	1	1	1	10	4	2	8	-1	-1	-1	-1	8	2	0
2362	4	10	10	4	3	3	10	10	1	6	6	0	-1	-1	6	6	-3
2366	1	10	1	1	1	1	10	1	2	9	0	0	0	0	9	0	1
2367	1	10	3	1	1	1	10	3	1	9	2	0	0	0	9	2	0
2368	2	10	2	2	2	2	10	1	1	8	0	0	0	0	8	-1	-1
2370	1	10	1	1	1	1	10	1	6	9	0	0	0	0	9	0	5
2371	3	10	1	1	1	1	10	3	4	7	-2	-2	-2	-2	7	0	1
2374	3	10	3	3	3	3	10	6	3	7	0	0	0	0	7	3	0
2377	1	10	3	1	1	1	10	3	4	9	2	0	0	0	9	2	3
2378	2	10	1	2	2	2	10	1	1	8	-1	0	0	0	8	-1	-1
2380	2	10	1	1	1	1	10	1	2	8	-1	-1	-1	-1	8	-1	0
2382	1	3	1	1	1	1	10	1	4	2	0	0	0	0	9	0	3
2383	2	10	10	1	1	1	10	10	1	8	8	-1	-1	-1	8	8	-1
2385	2	10	1	2	2	2	10	2	2	8	-1	0	0	0	8	0	0
2387	1	10	8	1	1	1	10	8	3	9	7	0	0	0	9	7	2
2388	4	10	1	2	2	2	10	10	1	6	-3	-2	-2	-2	6	6	-3
2392	2	10	4	1	1	1	10	10	2	8	2	-1	-1	-1	8	8	0
2394	3	10	1	2	2	2	10	10	1	7	-2	-1	-1	-1	7	7	-2
2397	2	10	1	2	2	2	10	2	3	8	-1	0	0	0	8	0	1
2399	1	10	2	1	1	1	10	10	3	9	1	0	0	0	9	9	2
2400	1	10	3	1	1	1	10	3	1	9	2	0	0	0	9	2	0
2401	3	10	4	0	0	0	10	10	2	7	1	-3	-3	-3	7	7	-1
2404	1	10	2	1	1	1	10	5	2	9	1	0	0	0	9	4	1
2405	1	10	1	1	1	1	10	9	1	9	0	0	0	0	9	8	0
2406	6	10	10	5	5	5	10	10	4	4	4	-1	-1	-1	4	4	-2
2412	1	10	1	1	1	1	10	3	2	9	0	0	0	0	9	2	1
2413	3	10	6	2	2	2	10	10	3	7	3	-1	-1	-1	7	7	0
2416	2	10	10	1	1	1	9	10	2	8	8	-1	-1	-1	7	8	0
2418	1	10	1	1	1	1	10	3	1	9	0	0	0	0	9	2	0
2419	1	10	4	0	0	0	10	2	4	9	3	-1	-1	-1	9	1	3
2420	2	10	10	1	1	1	10	10	1	8	8	-1	-1	-1	8	8	-1
2422	3	10	6	0	0	0	10	10	2	7	3	-3	-3	-3	7	7	-1
2425	6	10	10	0	0	0	10	10	1	4	4	-6	-6	-6	4	4	-5
2431	1	10	3	1	1	1	10	3	1	9	2	0	0	0	9	2	0
2432	2	10	2	2	2	2	10	10	4	8	0	0	0	0	8	8	2
2434	1	10	3	1	1	1	10	2	4	9	2	0	0	0	9	1	3
2435	4	10	1	1	1	1	10	10	5	6	-3	-3	-3	-3	6	6	1
2439	4	10	2	2	2	2	10	9	6	6	-2	-2	-2	-2	6	5	2
2443	4	10	1	4	4	4	10	6	2	6	-3	0	0	0	6	2	-2
2447	1	10	4	1	1	1	10	8	3	9	3	0	0	0	9	7	2
2448	1	10	1	1	1	1	10	1	2	9	0	0	0	0	9	0	1
2449	2	10	4	1	1	1	10	6	5	8	2	-1	-1	-1	8	4	3
2451	2	10	6	1	1	1	10	10	5	8	4	-1	-1	-1	8	8	3
2453	3	10	1	1	1	1	10	1	1	7	-2	-2	-2	-2	7	-2	-2
2456	3	10	2	1	1	1	10	3	6	7	-1	-2	-2	-2	7	0	3
2459	3	10	3	3	3	3	10	9	1	7	0	0	0	0	7	6	-2
2462	4	10	3	2	2	2	10	2	3	6	-1	-2	-2	-2	6	-2	-1
2466	1	10	1	1	1	1	10	10	1	9	0	0	0	0	9	9	0
2467	1	10	3	0	0	0	10	4	3	9	2	-1	-1	-1	9	3	2
2468	1	10	4	1	1	1	10	5	3	9	3	0	0	0	9	4	2
2469	4	10	10	2	2	2	10	10	4	6	6	-2	-2	-2	6	6	0
2473	4	10	10	1	1	1	10	10	1	6	6	-3	-3	-3	6	6	-3
2477	1	10	1	1	1	1	10	2	1	9	0	0	0	0	9	1	0
2478	5	10	10	4	5	5	10	10	4	5	5	-1	0	0	5	5	-1
2483	6	10	10	3	4	4	10	10	1	4	4	-3	-2	-2	4	4	-5
2489	4	10	1	4	4	4	10	10	2	6	-3	0	0	0	6	6	-2
2493	2	10	10	2	2	2	10	10	1	8	8	0	0	0	8	8	-1
2495	6	10	6	2	2	2	10	4	2	4	0	-4	-4	-4	4	-2	-4
2501	6	10	4	4	4	4	10	10	1	4	-2	-2	-2	-2	4	4	-5
2507	4	10	10	2	2	2	10	10	2	6	6	-2	-2	-2	6	6	-2
2511	1	10	1	1	1	1	10	3	1	9	0	0	0	0	9	2	0
2512	2	10	2	2	2	2	10	4	2	8	0	0	0	0	8	2	0
2514	2	10	3	1	1	1	10	10	1	8	1	-1	-1	-1	8	8	-1
2516	2	10	2	1	1	1	10	10	1	8	0	-1	-1	-1	8	8	-1
2518	3	9	1	1	1	1	10	4	3	6	-2	-2	-2	-2	7	1	0
2521	3	10	4	2	2	2	10	2	1	7	1	-1	-1	-1	7	-1	-2
2524	1	10	3	1	1	1	10	9	4	9	2	0	0	0	9	8	3
2525	4	10	6	3	3	3	10	10	5	6	2	-1	-1	-1	6	6	1
2529	2	10	10	1	1	1	10	10	1	8	8	-1	-1	-1	8	8	-1
2531	2	10	10	2	2	2	10	10	2	8	8	0	0	0	8	8	0
2533	3	10	3	1	1	1	10	9	3	7	0	-2	-2	-2	7	6	0
2536	4	10	1	2	2	2	10	10	3	6	-3	-2	-2	-2	6	6	-1
2540	4	10	4	1	1	1	10	10	1	6	0	-3	-3	-3	6	6	-3
2544	1	10	6	1	1	1	10	1	1	9	5	0	0	0	9	0	0
2545	8	10	4	6	6	6	10	4	1	2	-4	-2	-2	-2	2	-4	-7
2553	1	8	1	0	0	0	10	6	1	7	0	-1	-1	-1	9	5	0
2554	5	10	1	1	1	1	10	10	2	5	-4	-4	-4	-4	5	5	-3
2559	6	10	1	4	4	4	10	10	2	4	-5	-2	-2	-2	4	4	-4
2565	4	10	2	4	4	4	10	10	2	6	-2	0	0	0	6	6	-2
2569	1	10	10	1	1	1	10	10	3	9	9	0	0	0	9	9	2
2570	1	10	1	1	1	1	10	2	3	9	0	0	0	0	9	1	2
2571	1	10	10	1	1	1	10	10	3	9	9	0	0	0	9	9	2
2572	2	10	10	1	1	1	10	10	4	8	8	-1	-1	-1	8	8	2
2574	1	10	3	1	1	1	10	3	2	9	2	0	0	0	9	2	1
2575	2	10	10	2	2	2	10	10	2	8	8	0	0	0	8	8	0
2577	3	10	4	2	2	2	10	10	1	7	1	-1	-1	-1	7	7	-2
2580	1	10	1	1	1	1	10	3	1	9	0	0	0	0	9	2	0
2581	3	10	4	2	2	2	10	4	2	7	1	-1	-1	-1	7	1	-1
2584	1	10	4	1	1	1	10	1	2	9	3	0	0	0	9	0	1
2585	1	10	1	1	1	1	10	1	1	9	0	0	0	0	9	0	0
2586	1	10	1	1	1	1	10	10	4	9	0	0	0	0	9	9	3
2587	1	10	2	1	1	1	10	3	1	9	1	0	0	0	9	2	0
2588	2	9	1	1	1	1	10	1	4	7	-1	-1	-1	-1	8	-1	2
2590	2	10	10	2	2	2	10	10	2	8	8	0	0	0	8	8	0
2592	1	10	3	0	0	0	10	4	1	9	2	-1	-1	-1	9	3	0
2593	1	10	2	1	1	1	10	1	2	9	1	0	0	0	9	0	1
2594	2	10	1	2	2	2	10	10	2	8	-1	0	0	0	8	8	0
2596	1	10	1	0	0	0	10	1	3	9	0	-1	-1	-1	9	0	2
2597	4	10	4	1	1	1	10	6	2	6	0	-3	-3	-3	6	2	-2
2601	4	10	7	4	4	4	10	6	4	6	3	0	0	0	6	2	0
2605	1	10	3	1	1	1	10	10	1	9	2	0	0	0	9	9	0
2606	4	10	1	0	0	0	10	1	2	6	-3	-4	-4	-4	6	-3	-2
2610	2	10	10	1	1	1	10	10	1	8	8	-1	-1	-1	8	8	-1
2612	1	10	10	1	1	1	10	10	5	9	9	0	0	0	9	9	4
2613	1	10	3	1	1	1	10	4	2	9	2	0	0	0	9	3	1
2614	3	10	6	2	2	2	10	10	1	7	3	-1	-1	-1	7	7	-2
2617	1	1	1	0	0	0	10	1	3	0	0	-1	-1	-1	9	0	2
2618	1	10	3	1	1	1	10	3	1	9	2	0	0	0	9	2	0
2619	1	10	10	1	1	1	10	10	2	9	9	0	0	0	9	9	1
2620	2	10	2	2	2	2	10	7	4	8	0	0	0	0	8	5	2
2622	1	10	2	1	1	1	10	10	1	9	1	0	0	0	9	9	0
2623	3	10	3	0	0	0	10	7	2	7	0	-3	-3	-3	7	4	-1
2626	4	10	1	2	2	2	10	10	3	6	-3	-2	-2	-2	6	6	-1
2630	2	10	4	0	0	0	10	8	3	8	2	-2	-2	-2	8	6	1
2632	5	10	10	0	0	0	10	10	2	5	5	-5	-5	-5	5	5	-3
2637	1	10	3	1	1	1	10	10	2	9	2	0	0	0	9	9	1
2638	2	10	9	1	1	1	10	10	1	8	7	-1	-1	-1	8	8	-1
2640	1	10	4	1	1	1	10	6	2	9	3	0	0	0	9	5	1
2641	1	10	2	1	1	1	10	1	1	9	1	0	0	0	9	0	0
2642	2	10	10	2	2	2	10	8	6	8	8	0	0	0	8	6	4
2644	1	10	3	0	0	0	10	1	1	9	2	-1	-1	-1	9	0	0
2645	5	10	10	2	2	2	10	10	1	5	5	-3	-3	-3	5	5	-4
2650	1	10	5	1	1	1	10	4	2	9	4	0	0	0	9	3	1
2651	2	10	10	1	1	1	10	10	4	8	8	-1	-1	-1	8	8	2
2653	4	10	2	2	2	2	10	10	2	6	-2	-2	-2	-2	6	6	-2
2657	1	10	1	1	1	1	10	1	1	9	0	0	0	0	9	0	0
2658	2	10	1	2	2	2	10	4	4	8	-1	0	0	0	8	2	2
2660	3	10	10	2	2	2	10	10	2	7	7	-1	-1	-1	7	7	-1
2663	1	10	3	0	0	0	10	10	2	9	2	-1	-1	-1	9	9	1
2664	2	10	2	1	1	1	10	10	3	8	0	-1	-1	-1	8	8	1
2666	2	10	1	2	2	2	10	7	3	8	-1	0	0	0	8	5	1
2668	2	10	4	2	2	2	10	10	2	8	2	0	0	0	8	8	0
2670	1	10	3	1	1	1	10	4	3	9	2	0	0	0	9	3	2
2671	4	10	1	2	2	2	10	10	4	6	-3	-2	-2	-2	6	6	0
2675	2	10	6	1	1	1	10	10	3	8	4	-1	-1	-1	8	8	1
2677	1	10	10	1	1	1	10	10	1	9	9	0	0	0	9	9	0
2678	1	10	10	1	1	1	10	4	2	9	9	0	0	0	9	3	1
2679	2	10	3	2	2	2	10	1	1	8	1	0	0	0	8	-1	-1
2681	3	10	3	1	1	1	10	10	2	7	0	-2	-2	-2	7	7	-1
2684	1	10	6	1	1	1	10	10	2	9	5	0	0	0	9	9	1
2685	1	10	1	1	1	1	10	10	1	9	0	0	0	0	9	9	0
2686	1	10	9	1	1	1	10	9	1	9	8	0	0	0	9	8	0
2687	3	10	3	1	1	1	10	6	2	7	0	-2	-2	-2	7	3	-1
2690	3	10	10	2	2	2	10	10	4	7	7	-1	-1	-1	7	7	1
2693	4	10	3	4	4	4	10	10	1	6	-1	0	0	0	6	6	-3
2697	3	10	2	2	2	2	10	10	2	7	-1	-1	-1	-1	7	7	-1
2700	2	10	1	1	1	1	10	7	1	8	-1	-1	-1	-1	8	5	-1
2702	1	10	1	1	1	1	9	5	1	9	0	0	0	0	8	4	0
2703	1	10	3	1	1	1	10	8	2	9	2	0	0	0	9	7	1
2704	3	10	10	0	0	0	10	10	1	7	7	-3	-3	-3	7	7	-2
2707	4	10	2	2	2	2	10	10	1	6	-2	-2	-2	-2	6	6	-3
2711	2	10	10	0	0	0	10	10	2	8	8	-2	-2	-2	8	8	0
2713	1	10	1	1	1	1	10	10	1	9	0	0	0	0	9	9	0
2714	1	10	10	1	1	1	10	10	4	9	9	0	0	0	9	9	3
2715	2	10	2	1	1	1	10	10	1	8	0	-1	-1	-1	8	8	-1
2717	4	10	10	2	2	2	10	10	1	6	6	-2	-2	-2	6	6	-3
2721	1	10	3	1	1	1	10	3	2	9	2	0	0	0	9	2	1
2722	1	2	1	1	1	1	10	10	1	1	0	0	0	0	9	9	0
2723	5	10	2	2	2	2	10	10	1	5	-3	-3	-3	-3	5	5	-4
2728	2	10	1	1	1	1	10	1	1	8	-1	-1	-1	-1	8	-1	-1
2730	3	10	3	1	1	1	10	10	1	7	0	-2	-2	-2	7	7	-2
2733	1	10	6	1	1	1	10	4	2	9	5	0	0	0	9	3	1
2734	1	10	10	1	1	1	10	1	1	9	9	0	0	0	9	0	0
2735	1	10	1	1	1	1	10	1	2	9	0	0	0	0	9	0	1
2736	1	2	1	0	0	0	10	1	2	1	0	-1	-1	-1	9	0	1
2737	2	10	2	1	2	2	10	1	1	8	0	-1	0	0	8	-1	-1
2739	1	10	4	0	0	0	10	10	3	9	3	-1	-1	-1	9	9	2
2740	2	10	6	2	2	2	10	10	1	8	4	0	0	0	8	8	-1
2742	1	10	10	1	1	1	10	10	3	9	9	0	0	0	9	9	2
2743	1	10	5	1	1	1	10	10	4	9	4	0	0	0	9	9	3
2744	4	10	10	2	2	2	10	10	2	6	6	-2	-2	-2	6	6	-2
2748	1	10	5	1	1	1	10	10	1	9	4	0	0	0	9	9	0
2749	1	10	10	1	1	1	10	10	2	9	9	0	0	0	9	9	1
2750	1	10	2	1	1	1	10	3	3	9	1	0	0	0	9	2	2
2751	1	10	1	1	1	1	10	4	1	9	0	0	0	0	9	3	0
2752	4	10	1	1	1	1	10	10	1	6	-3	-3	-3	-3	6	6	-3
2756	1	10	10	1	1	1	10	3	1	9	9	0	0	0	9	2	0
2757	1	10	1	1	1	1	10	10	5	9	0	0	0	0	9	9	4
2758	3	10	8	0	0	0	10	3	2	7	5	-3	-3	-3	7	0	-1
2761	3	10	4	2	2	2	10	1	1	7	1	-1	-1	-1	7	-2	-2
2764	2	10	2	2	2	2	10	9	2	8	0	0	0	0	8	7	0
2766	1	10	2	1	1	1	10	1	6	9	1	0	0	0	9	0	5
2767	1	1	1	0	0	0	4	1	2	0	0	-1	-1	-1	3	0	1
2768	5	10	1	1	1	1	10	1	1	5	-4	-4	-4	-4	5	-4	-4
2773	2	10	6	1	1	1	10	1	1	8	4	-1	-1	-1	8	-1	-1
2775	2	10	6	2	2	2	10	10	1	8	4	0	0	0	8	8	-1
2777	2	10	6	2	2	2	10	10	1	8	4	0	0	0	8	8	-1
2779	2	10	3	0	0	0	10	6	2	8	1	-2	-2	-2	8	4	0
2781	1	10	1	1	1	1	10	1	4	9	0	0	0	0	9	0	3
2782	1	10	6	1	1	1	10	10	1	9	5	0	0	0	9	9	0
2783	7	10	1	4	4	4	10	3	3	3	-6	-3	-3	-3	3	-4	-4
2790	2	10	5	2	2	2	10	1	1	8	3	0	0	0	8	-1	-1
2792	6	10	1	3	2	2	10	10	2	4	-5	-3	-4	-4	4	4	-4
2798	1	3	1	0	0	0	10	3	2	2	0	-1	-1	-1	9	2	1
2799	2	10	6	1	1	1	10	1	3	8	4	-1	-1	-1	8	-1	1
2801	2	10	2	2	2	2	10	10	2	8	0	0	0	0	8	8	0
2803	1	10	3	1	1	1	10	5	1	9	2	0	0	0	9	4	0
2804	1	0	0	0	0	0	10	10	2	-1	-1	-1	-1	-1	9	9	1
2805	2	10	1	2	2	2	10	10	1	8	-1	0	0	0	8	8	-1
2807	1	10	1	0	0	0	10	5	4	9	0	-1	-1	-1	9	4	3
2808	2	10	7	1	1	1	10	10	2	8	5	-1	-1	-1	8	8	0
2810	4	10	1	1	1	1	10	8	5	6	-3	-3	-3	-3	6	4	1
2814	4	10	10	3	3	3	10	10	5	6	6	-1	-1	-1	6	6	1
2818	1	10	1	1	1	1	10	2	2	9	0	0	0	0	9	1	1
2819	3	10	3	1	1	1	10	10	3	7	0	-2	-2	-2	7	7	0
2822	1	10	1	0	0	0	10	1	1	9	0	-1	-1	-1	9	0	0
2823	6	10	2	4	4	4	10	10	2	4	-4	-2	-2	-2	4	4	-4
2829	2	10	9	1	1	1	10	10	5	8	7	-1	-1	-1	8	8	3
2831	1	10	5	1	1	1	10	10	1	9	4	0	0	0	9	9	0
2832	4	10	9	1	2	2	10	1	2	6	5	-3	-2	-2	6	-3	-2
2836	1	5	1	1	1	1	10	10	3	4	0	0	0	0	9	9	2
2837	1	3	1	0	0	0	10	3	2	2	0	-1	-1	-1	9	2	1
2838	1	10	4	0	0	0	10	6	1	9	3	-1	-1	-1	9	5	0
2839	3	10	1	2	2	2	10	2	3	7	-2	-1	-1	-1	7	-1	0
2842	1	10	10	1	1	1	10	1	4	9	9	0	0	0	9	0	3
2843	1	3	1	1	1	1	10	1	1	2	0	0	0	0	9	0	0
2844	3	10	10	3	3	3	10	2	1	7	7	0	0	0	7	-1	-2
2847	1	10	1	1	1	1	10	3	1	9	0	0	0	0	9	2	0
2848	1	10	2	0	0	0	10	10	2	9	1	-1	-1	-1	9	9	1
2849	1	10	10	1	1	1	10	10	3	9	9	0	0	0	9	9	2
2850	2	10	3	2	2	2	10	10	1	8	1	0	0	0	8	8	-1
2852	1	10	1	1	1	1	10	2	2	9	0	0	0	0	9	1	1
2853	2	10	1	1	1	1	10	10	1	8	-1	-1	-1	-1	8	8	-1
2855	1	10	1	1	1	1	10	1	3	9	0	0	0	0	9	0	2
2856	3	10	3	2	2	2	10	10	3	7	0	-1	-1	-1	7	7	0
2859	2	10	8	2	2	2	10	2	2	8	6	0	0	0	8	0	0
2861	1	0	0	0	0	0	4	1	1	-1	-1	-1	-1	-1	3	0	0
2862	1	10	3	0	0	0	10	10	2	9	2	-1	-1	-1	9	9	1
2863	2	10	2	2	2	2	10	10	1	8	0	0	0	0	8	8	-1
2865	1	10	1	1	1	1	10	1	1	9	0	0	0	0	9	0	0
2866	1	10	1	1	1	1	10	1	3	9	0	0	0	0	9	0	2
2867	4	10	1	1	1	1	10	10	5	6	-3	-3	-3	-3	6	6	1
2871	4	10	10	1	1	1	10	10	2	6	6	-3	-3	-3	6	6	-2
2875	3	10	3	3	3	3	10	10	4	7	0	0	0	0	7	7	1
2878	1	10	2	0	0	0	10	1	1	9	1	-1	-1	-1	9	0	0
2879	2	10	1	1	1	1	10	3	2	8	-1	-1	-1	-1	8	1	0
2881	4	10	10	2	2	2	10	10	1	6	6	-2	-2	-2	6	6	-3
2885	3	10	6	3	3	3	10	10	3	7	3	0	0	0	7	7	0
2888	4	10	10	1	1	1	10	10	2	6	6	-3	-3	-3	6	6	-2
2892	3	10	10	1	1	1	10	10	1	7	7	-2	-2	-2	7	7	-2
2895	4	10	4	1	1	1	10	1	2	6	0	-3	-3	-3	6	-3	-2
2899	4	10	3	2	2	2	10	9	1	6	-1	-2	-2	-2	6	5	-3
2903	2	10	6	1	1	1	10	10	4	8	4	-1	-1	-1	8	8	2
2905	1	10	10	0	0	0	10	10	1	9	9	-1	-1	-1	9	9	0
2906	4	10	1	2	2	2	10	10	3	6	-3	-2	-2	-2	6	6	-1
2910	1	10	3	1	1	1	10	1	1	9	2	0	0	0	9	0	0
2911	2	6	1	1	1	1	10	9	4	4	-1	-1	-1	-1	8	7	2
2913	2	10	9	1	1	1	10	9	1	8	7	-1	-1	-1	8	7	-1
2915	2	10	1	2	2	2	10	10	2	8	-1	0	0	0	8	8	0
2917	1	10	1	1	1	1	10	10	3	9	0	0	0	0	9	9	2
2918	1	10	6	1	1	1	10	1	5	9	5	0	0	0	9	0	4
2919	1	10	10	1	1	1	10	4	1	9	9	0	0	0	9	3	0
2920	1	10	6	1	1	1	10	10	1	9	5	0	0	0	9	9	0
2921	1	10	3	1	1	1	10	2	1	9	2	0	0	0	9	1	0
2922	3	10	2	1	1	1	10	10	5	7	-1	-2	-2	-2	7	7	2
2925	3	10	3	3	3	3	10	9	1	7	0	0	0	0	7	6	-2
2928	2	10	3	1	2	2	10	3	1	8	1	-1	0	0	8	1	-1
2930	2	10	2	2	2	2	10	6	1	8	0	0	0	0	8	4	-1
2932	1	10	10	0	0	0	10	10	1	9	9	-1	-1	-1	9	9	0
2933	5	10	10	4	4	4	10	10	5	5	5	-1	-1	-1	5	5	0
2938	4	10	2	3	3	3	10	3	3	6	-2	-1	-1	-1	6	-1	-1
2942	2	10	1	1	1	1	10	1	1	8	-1	-1	-1	-1	8	-1	-1
2944	1	10	10	1	1	1	10	10	2	9	9	0	0	0	9	9	1
2945	3	10	10	2	2	2	10	10	4	7	7	-1	-1	-1	7	7	1
2948	1	10	10	0	0	0	10	10	2	9	9	-1	-1	-1	9	9	1
2949	1	10	1	1	1	1	10	10	3	9	0	0	0	0	9	9	2
2950	2	10	1	0	0	0	10	10	1	8	-1	-2	-2	-2	8	8	-1
2952	2	10	10	1	1	1	10	10	2	8	8	-1	-1	-1	8	8	0
2954	2	10	1	1	1	1	10	2	4	8	-1	-1	-1	-1	8	0	2
2956	3	10	1	3	3	3	10	10	2	7	-2	0	0	0	7	7	-1
2959	4	10	1	0	0	0	10	10	2	6	-3	-4	-4	-4	6	6	-2
2963	5	10	2	1	1	1	10	10	3	5	-3	-4	-4	-4	5	5	-2
2968	1	10	1	1	1	1	10	10	2	9	0	0	0	0	9	9	1
2969	3	10	1	3	3	3	10	3	3	7	-2	0	0	0	7	0	0
2972	1	10	10	0	0	0	10	10	2	9	9	-1	-1	-1	9	9	1
2973	3	10	5	1	1	1	10	10	3	7	2	-2	-2	-2	7	7	0
2976	1	10	6	0	0	0	10	4	1	9	5	-1	-1	-1	9	3	0
2977	1	10	1	1	1	1	10	1	1	9	0	0	0	0	9	0	0
2978	2	10	1	1	1	1	10	10	2	8	-1	-1	-1	-1	8	8	0
2980	1	10	10	1	1	1	10	2	3	9	9	0	0	0	9	1	2
2981	6	10	10	1	2	2	10	10	4	4	4	-5	-4	-4	4	4	-2
2987	1	10	1	1	1	1	10	3	4	9	0	0	0	0	9	2	3
2988	2	10	1	2	2	2	10	10	4	8	-1	0	0	0	8	8	2
2990	5	10	8	2	2	2	10	10	2	5	3	-3	-3	-3	5	5	-3
2995	4	10	10	1	1	1	10	10	3	6	6	-3	-3	-3	6	6	-1
2999	2	10	1	1	1	1	10	1	1	8	-1	-1	-1	-1	8	-1	-1
3001	1	9	1	1	1	1	10	1	3	8	0	0	0	0	9	0	2
3002	1	10	3	1	1	1	10	3	7	9	2	0	0	0	9	2	6
3003	1	10	3	1	1	1	10	1	1	9	2	0	0	0	9	0	0
3004	4	10	1	1	1	1	10	10	2	6	-3	-3	-3	-3	6	6	-2
3008	2	10	1	0	0	0	10	1	4	8	-1	-2	-2	-2	8	-1	2
3010	1	10	4	1	1	1	10	10	1	9	3	0	0	0	9	9	0
3011	2	10	5	1	1	1	10	10	1	8	3	-1	-1	-1	8	8	-1
3013	2	10	2	0	0	0	10	1	2	8	0	-2	-2	-2	8	-1	0
3015	1	10	2	0	0	0	10	10	1	9	1	-1	-1	-1	9	9	0
3016	5	10	1	4	4	4	10	10	2	5	-4	-1	-1	-1	5	5	-3
3021	1	10	10	1	1	1	10	10	2	9	9	0	0	0	9	9	1
3022	3	10	5	2	2	2	10	10	1	7	2	-1	-1	-1	7	7	-2
3025	3	10	10	2	2	2	10	10	2	7	7	-1	-1	-1	7	7	-1
3028	3	10	4	3	3	3	10	10	1	7	1	0	0	0	7	7	-2
3031	1	10	4	1	1	1	10	10	3	9	3	0	0	0	9	9	2
3032	4	10	10	1	1	1	10	10	1	6	6	-3	-3	-3	6	6	-3
3036	4	10	3	0	0	0	10	10	3	6	-1	-4	-4	-4	6	6	-1
3040	1	10	10	0	0	0	10	1	2	9	9	-1	-1	-1	9	0	1
3041	2	10	10	1	1	1	10	10	1	8	8	-1	-1	-1	8	8	-1
3043	3	10	10	1	1	1	10	7	1	7	7	-2	-2	-2	7	4	-2
3046	2	10	4	0	0	0	10	9	6	8	2	-2	-2	-2	8	7	4
3048	1	10	1	0	0	0	10	10	1	9	0	-1	-1	-1	9	9	0
3049	1	10	9	1	1	1	10	7	2	9	8	0	0	0	9	6	1
3050	1	10	2	1	1	1	10	1	3	9	1	0	0	0	9	0	2
3051	2	10	10	0	0	0	10	10	2	8	8	-2	-2	-2	8	8	0
3053	1	10	6	1	1	1	10	10	2	9	5	0	0	0	9	9	1
3054	1	10	2	1	1	1	10	1	1	9	1	0	0	0	9	0	0
3055	3	10	9	2	2	2	10	1	2	7	6	-1	-1	-1	7	-2	-1
3058	1	10	10	1	1	1	10	10	2	9	9	0	0	0	9	9	1
3059	3	10	1	0	0	0	10	10	1	7	-2	-3	-3	-3	7	7	-2
3062	2	10	10	1	1	1	10	10	6	8	8	-1	-1	-1	8	8	4
3064	2	10	10	1	1	1	10	10	5	8	8	-1	-1	-1	8	8	3
3066	1	10	8	1	1	1	10	10	2	9	7	0	0	0	9	9	1
3067	3	10	8	3	3	3	10	2	3	7	5	0	0	0	7	-1	0
3070	2	10	10	2	2	2	10	10	3	8	8	0	0	0	8	8	1
3072	5	10	10	2	2	2	10	10	4	5	5	-3	-3	-3	5	5	-1
3077	5	10	4	4	4	4	10	4	1	5	-1	-1	-1	-1	5	-1	-4
3082	4	10	2	0	0	0	10	1	1	6	-2	-4	-4	-4	6	-3	-3
3086	1	10	10	1	1	1	10	10	3	9	9	0	0	0	9	9	2
3087	2	10	1	0	0	0	10	4	3	8	-1	-2	-2	-2	8	2	1
3089	5	10	10	3	3	3	10	10	1	5	5	-2	-2	-2	5	5	-4
3094	3	10	2	1	1	1	10	10	2	7	-1	-2	-2	-2	7	7	-1
3097	2	10	3	2	2	2	10	3	1	8	1	0	0	0	8	1	-1
3099	1	10	3	1	1	1	10	3	1	9	2	0	0	0	9	2	0
3100	1	10	2	1	1	1	10	10	1	9	1	0	0	0	9	9	0
3101	1	10	4	1	1	1	10	10	1	9	3	0	0	0	9	9	0
3102	2	10	3	0	0	0	10	4	2	8	1	-2	-2	-2	8	2	0
3104	4	10	6	3	3	3	10	10	3	6	2	-1	-1	-1	6	6	-1
3108	4	10	3	3	3	3	10	10	2	6	-1	-1	-1	-1	6	6	-2
3112	4	10	10	3	3	3	10	6	3	6	6	-1	-1	-1	6	2	-1
3116	1	10	6	1	1	1	10	1	3	9	5	0	0	0	9	0	2
3117	8	10	6	2	2	2	10	10	3	2	-2	-6	-6	-6	2	2	-5
3125	3	10	10	1	1	1	10	10	2	7	7	-2	-2	-2	7	7	-1
3128	4	10	4	2	2	2	10	10	1	6	0	-2	-2	-2	6	6	-3
3132	2	10	10	2	2	2	10	10	1	8	8	0	0	0	8	8	-1
3134	5	10	1	4	4	4	10	10	3	5	-4	-1	-1	-1	5	5	-2
3139	1	10	6	1	1	1	10	10	1	9	5	0	0	0	9	9	0
3140	7	10	2	2	3	3	10	10	3	3	-5	-5	-4	-4	3	3	-4
3147	7	10	10	2	2	2	10	10	5	3	3	-5	-5	-5	3	3	-2
3154	4	10	10	0	0	0	10	10	2	6	6	-4	-4	-4	6	6	-2
3158	1	10	1	1	1	1	10	2	3	9	0	0	0	0	9	1	2
3159	6	10	1	2	2	2	10	10	7	4	-5	-4	-4	-4	4	4	1
3165	2	10	2	2	2	2	10	1	3	8	0	0	0	0	8	-1	1
3167	4	10	4	0	0	0	10	1	2	6	0	-4	-4	-4	6	-3	-2
3171	2	10	3	2	2	2	10	7	2	8	1	0	0	0	8	5	0
3173	2	10	2	2	2	2	10	9	5	8	0	0	0	0	8	7	3
3175	4	10	2	4	4	4	10	10	1	6	-2	0	0	0	6	6	-3
3179	1	10	3	1	1	1	10	1	3	9	2	0	0	0	9	0	2
3180	3	10	3	3	3	3	10	10	1	7	0	0	0	0	7	7	-2
3183	3	10	3	2	2	2	10	10	8	7	0	-1	-1	-1	7	7	5
3186	1	10	10	1	1	1	10	10	1	9	9	0	0	0	9	9	0
3187	1	10	1	1	1	1	10	1	2	9	0	0	0	0	9	0	1
3188	1	9	1	1	1	1	10	1	4	8	0	0	0	0	9	0	3
3189	2	10	10	1	1	1	10	10	1	8	8	-1	-1	-1	8	8	-1
3191	2	10	6	2	2	2	10	10	2	8	4	0	0	0	8	8	0
3193	1	10	3	1	1	1	10	6	1	9	2	0	0	0	9	5	0
3194	4	10	3	1	1	1	10	5	3	6	-1	-3	-3	-3	6	1	-1
3198	2	10	1	2	2	2	10	1	3	8	-1	0	0	0	8	-1	1
3200	2	10	6	2	2	2	10	3	3	8	4	0	0	0	8	1	1
3202	2	10	9	0	0	0	10	3	2	8	7	-2	-2	-2	8	1	0
3204	2	10	10	2	2	2	10	10	3	8	8	0	0	0	8	8	1
3206	1	10	10	0	0	0	10	4	1	9	9	-1	-1	-1	9	3	0
3207	2	10	6	0	0	0	10	1	4	8	4	-2	-2	-2	8	-1	2
3209	1	10	1	1	1	1	10	1	2	9	0	0	0	0	9	0	1
3210	4	10	9	1	1	1	10	10	1	6	5	-3	-3	-3	6	6	-3
3214	2	10	10	2	2	2	10	10	3	8	8	0	0	0	8	8	1
3216	1	10	3	1	1	1	10	3	2	9	2	0	0	0	9	2	1
3217	2	10	3	1	1	1	10	2	3	8	1	-1	-1	-1	8	0	1
3219	1	10	1	1	1	1	10	2	4	9	0	0	0	0	9	1	3
3220	2	10	3	0	0	0	10	10	3	8	1	-2	-2	-2	8	8	1
3222	1	10	10	0	0	0	10	10	2	9	9	-1	-1	-1	9	9	1
3223	7	10	2	3	3	3	10	9	3	3	-5	-4	-4	-4	3	2	-4
3230	1	10	4	0	0	0	10	9	2	9	3	-1	-1	-1	9	8	1
3231	1	10	1	1	1	1	10	2	1	9	0	0	0	0	9	1	0
3232	2	10	1	2	2	2	10	1	4	8	-1	0	0	0	8	-1	2
3234	1	10	3	1	1	1	10	3	4	9	2	0	0	0	9	2	3
3235	3	10	10	3	3	3	10	10	2	7	7	0	0	0	7	7	-1
3238	2	10	6	2	2	2	10	6	2	8	4	0	0	0	8	4	0
3240	3	10	1	0	0	0	10	10	3	7	-2	-3	-3	-3	7	7	0
3243	1	9	3	1	1	1	10	5	2	8	2	0	0	0	9	4	1
3244	8	10	1	1	1	1	10	4	2	2	-7	-7	-7	-7	2	-4	-6
3252	4	10	1	4	4	4	10	10	2	6	-3	0	0	0	6	6	-2
3256	1	10	2	1	1	1	10	1	5	9	1	0	0	0	9	0	4
3257	4	10	8	3	3	3	10	1	1	6	4	-1	-1	-1	6	-3	-3
3261	2	10	1	0	0	0	10	10	1	8	-1	-2	-2	-2	8	8	-1
3263	1	10	1	0	0	0	10	5	1	9	0	-1	-1	-1	9	4	0
3264	3	10	7	3	3	3	10	6	4	7	4	0	0	0	7	3	1
3267	1	10	7	1	1	1	10	9	2	9	6	0	0	0	9	8	1
3268	3	10	4	3	3	3	10	10	1	7	1	0	0	0	7	7	-2
3271	2	10	2	1	1	1	10	2	1	8	0	-1	-1	-1	8	0	-1
3273	3	10	2	2	2	2	10	4	1	7	-1	-1	-1	-1	7	1	-2
3276	3	10	6	1	1	1	10	10	3	7	3	-2	-2	-2	7	7	0
3279	1	10	1	1	1	1	10	1	2	9	0	0	0	0	9	0	1
3280	2	10	2	2	2	2	10	10	4	8	0	0	0	0	8	8	2
3282	3	10	1	3	3	3	10	10	1	7	-2	0	0	0	7	7	-2
3285	3	10	7	2	2	2	10	9	1	7	4	-1	-1	-1	7	6	-2
3288	2	10	1	2	2	2	10	10	5	8	-1	0	0	0	8	8	3
3290	1	10	4	0	0	0	9	6	6	9	3	-1	-1	-1	8	5	5
3291	1	10	6	0	0	0	10	10	1	9	5	-1	-1	-1	9	9	0
3292	1	10	6	1	1	1	10	4	3	9	5	0	0	0	9	3	2
3293	1	10	1	1	1	1	10	2	3	9	0	0	0	0	9	1	2
3294	1	10	5	1	1	1	10	3	1	9	4	0	0	0	9	2	0
3295	1	10	2	1	1	1	10	2	1	9	1	0	0	0	9	1	0
3296	3	10	1	2	2	2	10	10	2	7	-2	-1	-1	-1	7	7	-1
3299	2	7	1	1	1	1	10	6	3	5	-1	-1	-1	-1	8	4	1
3301	1	10	10	1	1	1	10	10	4	9	9	0	0	0	9	9	3
3302	2	10	5	1	1	1	10	10	1	8	3	-1	-1	-1	8	8	-1
3304	3	10	6	3	3	3	10	1	1	7	3	0	0	0	7	-2	-2
3307	2	10	1	2	2	2	10	1	4	8	-1	0	0	0	8	-1	2
3309	4	10	6	1	1	1	10	10	1	6	2	-3	-3	-3	6	6	-3
3313	1	10	1	1	1	1	10	1	1	9	0	0	0	0	9	0	0
3314	1	10	6	1	1	1	10	10	3	9	5	0	0	0	9	9	2
3315	2	10	1	2	2	2	10	5	1	8	-1	0	0	0	8	3	-1
3317	1	10	2	1	1	1	10	10	1	9	1	0	0	0	9	9	0
3318	1	10	4	1	1	1	10	1	4	9	3	0	0	0	9	0	3
3319	7	10	10	5	5	5	10	10	3	3	3	-2	-2	-2	3	3	-4
3326	5	10	9	4	4	4	10	10	4	5	4	-1	-1	-1	5	5	-1
3331	3	10	3	3	3	3	10	10	1	7	0	0	0	0	7	7	-2
3334	7	10	10	3	3	3	10	10	3	3	3	-4	-4	-4	3	3	-4
3341	1	10	3	1	1	1	10	3	5	9	2	0	0	0	9	2	4
3342	4	10	10	2	2	2	10	10	3	6	6	-2	-2	-2	6	6	-1
3346	5	10	1	2	2	2	10	10	1	5	-4	-3	-3	-3	5	5	-4
3351	2	3	1	0	0	0	10	3	1	1	-1	-2	-2	-2	8	1	-1
3353	4	10	3	2	2	2	10	10	1	6	-1	-2	-2	-2	6	6	-3
3357	2	10	3	1	1	1	10	10	3	8	1	-1	-1	-1	8	8	1
3359	1	10	1	1	1	1	10	1	2	9	0	0	0	0	9	0	1
3360	3	10	10	1	1	1	10	10	4	7	7	-2	-2	-2	7	7	1
3363	1	10	10	0	0	0	10	8	1	9	9	-1	-1	-1	9	7	0
3364	2	10	1	2	2	2	10	3	4	8	-1	0	0	0	8	1	2
3366	5	10	1	3	3	3	10	10	3	5	-4	-2	-2	-2	5	5	-2
3371	1	10	2	1	1	1	10	1	5	9	1	0	0	0	9	0	4
3372	1	10	3	1	1	1	10	2	4	9	2	0	0	0	9	1	3
3373	1	0	0	0	0	0	10	2	3	-1	-1	-1	-1	-1	9	1	2
3374	2	10	1	2	2	2	10	10	1	8	-1	0	0	0	8	8	-1
3376	2	10	3	1	1	1	10	1	3	8	1	-1	-1	-1	8	-1	1
3378	5	10	9	4	4	4	10	2	4	5	4	-1	-1	-1	5	-3	-1
3383	3	10	10	1	1	1	10	10	1	7	7	-2	-2	-2	7	7	-2
3386	1	10	10	1	1	1	10	10	1	9	9	0	0	0	9	9	0
3387	1	10	2	0	0	0	10	3	2	9	1	-1	-1	-1	9	2	1
3388	1	10	3	1	1	1	10	10	1	9	2	0	0	0	9	9	0
3389	2	10	1	1	1	1	10	10	2	8	-1	-1	-1	-1	8	8	0
3391	1	10	2	1	1	1	10	4	1	9	1	0	0	0	9	3	0
3392	1	10	10	0	0	0	10	10	3	9	9	-1	-1	-1	9	9	2
3393	6	10	1	1	1	1	10	10	3	4	-5	-5	-5	-5	4	4	-3
3399	1	10	5	1	1	1	10	10	3	9	4	0	0	0	9	9	2
3400	2	10	6	0	0	0	10	10	2	8	4	-2	-2	-2	8	8	0
3402	1	3	1	1	1	1	10	1	2	2	0	0	0	0	9	0	1
3403	1	2	1	1	1	1	10	1	3	1	0	0	0	0	9	0	2
3404	9	10	1	2	2	2	10	10	1	1	-8	-7	-7	-7	1	1	-8
3413	1	10	3	1	1	1	10	3	2	9	2	0	0	0	9	2	1
3414	2	10	6	2	2	2	10	4	3	8	4	0	0	0	8	2	1
3416	2	10	6	1	1	1	10	10	2	8	4	-1	-1	-1	8	8	0
3418	1	10	8	1	1	1	10	10	3	9	7	0	0	0	9	9	2
3419	1	10	4	1	1	1	10	10	1	9	3	0	0	0	9	9	0
3420	2	10	3	2	2	2	10	1	2	8	1	0	0	0	8	-1	0
3422	5	10	1	3	3	3	10	10	1	5	-4	-2	-2	-2	5	5	-4
3427	1	10	3	1	1	1	10	3	1	9	2	0	0	0	9	2	0
3428	2	10	2	2	2	2	10	10	3	8	0	0	0	0	8	8	1
3430	2	10	2	1	1	1	10	10	1	8	0	-1	-1	-1	8	8	-1
3432	3	10	10	3	3	3	10	10	5	7	7	0	0	0	7	7	2
3435	1	10	2	1	1	1	10	10	1	9	1	0	0	0	9	9	0
3436	1	10	2	1	1	1	10	1	1	9	1	0	0	0	9	0	0
3437	1	10	10	1	1	1	10	10	2	9	9	0	0	0	9	9	1
3438	1	10	2	1	1	1	10	2	3	9	1	0	0	0	9	1	2
3439	4	10	2	4	4	4	10	1	1	6	-2	0	0	0	6	-3	-3
3443	3	10	2	3	3	3	10	3	1	7	-1	0	0	0	7	0	-2
3446	1	10	5	1	1	1	10	10	6	9	4	0	0	0	9	9	5
3447	5	10	1	3	3	3	10	10	1	5	-4	-2	-2	-2	5	5	-4
3452	2	10	2	0	0	0	10	10	1	8	0	-2	-2	-2	8	8	-1
3454	1	10	4	1	1	1	10	1	1	9	3	0	0	0	9	0	0
3455	6	10	10	4	4	4	10	10	1	4	4	-2	-2	-2	4	4	-5
3461	2	10	10	1	2	2	10	10	2	8	8	-1	0	0	8	8	0
3463	1	0	0	0	0	0	10	10	1	-1	-1	-1	-1	-1	9	9	0
3464	2	10	1	2	2	2	10	3	4	8	-1	0	0	0	8	1	2
3466	1	10	3	1	1	1	10	10	2	9	2	0	0	0	9	9	1
3467	3	10	4	2	2	2	10	6	1	7	1	-1	-1	-1	7	3	-2
3470	1	10	3	1	1	1	10	3	3	9	2	0	0	0	9	2	2
3471	4	10	9	3	3	3	10	10	6	6	5	-1	-1	-1	6	6	2
3475	3	10	10	2	2	2	10	10	1	7	7	-1	-1	-1	7	7	-2
3478	1	8	6	1	1	1	10	10	1	7	5	0	0	0	9	9	0
3479	4	10	2	2	2	2	10	10	2	6	-2	-2	-2	-2	6	6	-2
3483	3	10	2	3	3	3	10	3	2	7	-1	0	0	0	7	0	-1
3486	1	10	3	1	1	1	10	1	4	9	2	0	0	0	9	0	3
3487	1	10	1	1	1	1	9	4	1	9	0	0	0	0	8	3	0
3488	1	10	2	1	1	1	10	1	4	9	1	0	0	0	9	0	3
3489	2	7	1	1	1	1	10	9	3	5	-1	-1	-1	-1	8	7	1
3491	2	10	3	2	2	2	10	10	3	8	1	0	0	0	8	8	1
3493	1	10	3	0	0	0	10	1	1	9	2	-1	-1	-1	9	0	0
3494	1	10	1	0	0	0	10	2	2	9	0	-1	-1	-1	9	1	1
3495	2	10	2	2	2	2	10	1	3	8	0	0	0	0	8	-1	1
3497	3	10	1	2	2	2	10	7	3	7	-2	-1	-1	-1	7	4	0
3500	3	10	1	2	2	2	10	9	1	7	-2	-1	-1	-1	7	6	-2
3503	4	10	3	2	2	2	10	10	4	6	-1	-2	-2	-2	6	6	0
3507	2	10	10	1	1	1	10	3	2	8	8	-1	-1	-1	8	1	0
3509	6	10	2	3	3	3	10	10	4	4	-4	-3	-3	-3	4	4	-2
3515	1	10	10	1	1	1	10	2	1	9	9	0	0	0	9	1	0
3516	3	10	3	2	2	2	10	10	1	7	0	-1	-1	-1	7	7	-2
3519	2	10	1	0	0	0	10	1	1	8	-1	-2	-2	-2	8	-1	-1
3521	3	10	1	3	3	3	10	10	1	7	-2	0	0	0	7	7	-2
3524	1	10	9	0	0	0	10	3	2	9	8	-1	-1	-1	9	2	1
3525	2	10	10	1	1	1	10	10	1	8	8	-1	-1	-1	8	8	-1
3527	4	10	2	2	2	2	10	10	1	6	-2	-2	-2	-2	6	6	-3
3531	4	10	10	1	2	2	10	10	4	6	6	-3	-2	-2	6	6	0
3535	4	10	9	2	2	2	10	10	4	6	5	-2	-2	-2	6	6	0
3539	1	10	10	1	1	1	10	3	2	9	9	0	0	0	9	2	1
3540	3	10	1	2	3	3	10	10	4	7	-2	-1	0	0	7	7	1
3543	4	10	10	2	2	2	10	10	4	6	6	-2	-2	-2	6	6	0
3547	2	10	3	1	1	1	10	10	2	8	1	-1	-1	-1	8	8	0
3549	1	10	6	1	1	1	10	9	3	9	5	0	0	0	9	8	2
3550	1	10	1	1	1	1	10	10	3	9	0	0	0	0	9	9	2
3551	4	10	3	2	2	2	10	10	2	6	-1	-2	-2	-2	6	6	-2
3555	1	7	1	1	1	1	10	1	2	6	0	0	0	0	9	0	1
3556	2	10	1	2	2	2	10	10	1	8	-1	0	0	0	8	8	-1
3558	4	10	4	3	3	3	10	10	2	6	0	-1	-1	-1	6	6	-2
3562	5	10	5	1	1	1	10	10	3	5	0	-4	-4	-4	5	5	-2
3567	3	10	2	2	2	2	10	3	3	7	-1	-1	-1	-1	7	0	0
3570	3	10	10	2	2	2	10	10	3	7	7	-1	-1	-1	7	7	0
3573	1	10	1	1	1	1	10	2	1	9	0	0	0	0	9	1	0
3574	2	10	10	2	2	2	10	10	1	8	8	0	0	0	8	8	-1
3576	1	10	1	1	1	1	10	10	1	9	0	0	0	0	9	9	0
3577	1	10	6	1	1	1	10	6	4	9	5	0	0	0	9	5	3
3578	6	10	10	4	4	4	10	8	5	4	4	-2	-2	-2	4	2	-1
3584	1	10	4	0	0	0	10	8	1	9	3	-1	-1	-1	9	7	0
3585	2	10	2	2	2	2	10	2	3	8	0	0	0	0	8	0	1
3587	4	10	10	1	1	1	10	10	5	6	6	-3	-3	-3	6	6	1
3591	2	10	1	2	2	2	10	9	1	8	-1	0	0	0	8	7	-1
3593	2	10	2	2	2	2	10	2	3	8	0	0	0	0	8	0	1
3595	4	10	1	1	1	1	10	10	1	6	-3	-3	-3	-3	6	6	-3
3599	1	10	9	1	1	1	10	10	1	9	8	0	0	0	9	9	0
3600	4	10	4	2	2	2	10	3	1	6	0	-2	-2	-2	6	-1	-3
3604	2	10	10	1	1	1	10	10	1	8	8	-1	-1	-1	8	8	-1
3606	2	10	1	1	1	1	10	6	1	8	-1	-1	-1	-1	8	4	-1
3608	1	10	10	1	1	1	10	6	2	9	9	0	0	0	9	5	1
3609	1	10	4	1	1	1	10	3	2	9	3	0	0	0	9	2	1
3610	2	10	6	1	1	1	10	3	3	8	4	-1	-1	-1	8	1	1
3612	1	10	3	1	1	1	10	10	3	9	2	0	0	0	9	9	2
3613	1	10	1	1	1	1	10	2	2	9	0	0	0	0	9	1	1
3614	1	10	4	0	0	0	10	10	4	9	3	-1	-1	-1	9	9	3
3615	1	10	5	1	1	1	10	1	5	9	4	0	0	0	9	0	4
3616	2	10	10	2	2	2	10	2	3	8	8	0	0	0	8	0	1
3618	2	10	1	2	2	2	10	4	1	8	-1	0	0	0	8	2	-1
3620	1	10	1	1	1	1	10	10	1	9	0	0	0	0	9	9	0
3621	1	10	2	1	1	1	10	6	2	9	1	0	0	0	9	5	1
3622	4	10	1	2	2	2	10	6	4	6	-3	-2	-2	-2	6	2	0
3626	2	10	1	2	2	2	10	1	1	8	-1	0	0	0	8	-1	-1
3628	4	10	7	1	1	1	10	10	1	6	3	-3	-3	-3	6	6	-3
3632	1	10	4	1	1	1	10	10	1	9	3	0	0	0	9	9	0
3633	3	10	2	3	3	3	10	1	3	7	-1	0	0	0	7	-2	0
3636	5	10	10	4	4	4	10	10	3	5	5	-1	-1	-1	5	5	-2
3641	3	10	10	1	1	1	10	6	1	7	7	-2	-2	-2	7	3	-2
3644	2	10	6	1	1	1	10	3	3	8	4	-1	-1	-1	8	1	1
3646	4	10	2	4	4	4	10	10	2	6	-2	0	0	0	6	6	-2
3650	3	10	2	1	1	1	10	10	1	7	-1	-2	-2	-2	7	7	-2
3653	4	10	4	3	3	3	10	10	3	6	0	-1	-1	-1	6	6	-1
3657	3	10	2	2	2	2	10	1	1	7	-1	-1	-1	-1	7	-2	-2
3660	3	10	1	2	2	2	10	9	1	7	-2	-1	-1	-1	7	6	-2
3663	1	10	2	1	1	1	10	1	3	9	1	0	0	0	9	0	2
3664	4	10	2	3	3	3	10	9	1	6	-2	-1	-1	-1	6	5	-3
3668	1	10	10	1	1	1	10	2	3	9	9	0	0	0	9	1	2
3669	2	10	1	2	2	2	10	4	1	8	-1	0	0	0	8	2	-1
3671	2	10	6	2	2	2	10	10	2	8	4	0	0	0	8	8	0
3673	1	10	2	1	1	1	10	3	1	9	1	0	0	0	9	2	0
3674	1	9	1	1	1	1	10	1	1	8	0	0	0	0	9	0	0
3675	1	10	2	1	1	1	10	10	1	9	1	0	0	0	9	9	0
3676	3	10	10	2	2	2	10	5	2	7	7	-1	-1	-1	7	2	-1
3679	4	10	1	4	4	4	10	10	2	6	-3	0	0	0	6	6	-2
3683	3	10	3	3	3	3	10	7	1	7	0	0	0	0	7	4	-2
3686	1	10	3	1	1	1	10	10	2	9	2	0	0	0	9	9	1
3687	1	10	10	0	0	0	10	10	1	9	9	-1	-1	-1	9	9	0
3688	2	10	10	2	2	2	10	10	1	8	8	0	0	0	8	8	-1
3690	2	10	10	1	1	1	10	10	3	8	8	-1	-1	-1	8	8	1
3692	2	10	10	1	1	1	10	10	2	8	8	-1	-1	-1	8	8	0
3694	2	10	2	2	2	2	10	1	2	8	0	0	0	0	8	-1	0
3696	3	10	10	1	1	1	10	10	3	7	7	-2	-2	-2	7	7	0
3699	1	10	6	1	1	1	10	10	4	9	5	0	0	0	9	9	3
3700	2	10	8	1	2	2	10	1	3	8	6	-1	0	0	8	-1	1
3702	3	10	5	2	2	2	10	10	1	7	2	-1	-1	-1	7	7	-2
3705	3	10	6	2	2	2	10	6	5	7	3	-1	-1	-1	7	3	2
3708	4	10	10	3	3	3	10	10	1	6	6	-1	-1	-1	6	6	-3
3712	1	10	2	0	0	0	10	10	2	9	1	-1	-1	-1	9	9	1
3713	1	10	1	0	0	0	10	6	5	9	0	-1	-1	-1	9	5	4
3714	1	10	10	1	1	1	10	10	4	9	9	0	0	0	9	9	3
3715	3	10	10	1	1	1	10	10	2	7	7	-2	-2	-2	7	7	-1
3718	2	10	10	1	2	2	10	10	1	8	8	-1	0	0	8	8	-1
3720	1	10	4	1	1	1	10	8	2	9	3	0	0	0	9	7	1
3721	3	10	2	3	3	3	10	10	3	7	-1	0	0	0	7	7	0
3724	2	10	2	1	1	1	10	1	4	8	0	-1	-1	-1	8	-1	2
3726	3	10	3	1	1	1	10	1	1	7	0	-2	-2	-2	7	-2	-2
3729	3	10	10	3	3	3	10	10	1	7	7	0	0	0	7	7	-2
3732	3	10	3	1	1	1	10	8	1	7	0	-2	-2	-2	7	5	-2
3735	9	10	3	5	4	4	10	10	2	1	-6	-4	-5	-5	1	1	-7
3744	1	10	8	1	1	1	10	1	1	9	7	0	0	0	9	0	0
3745	4	10	10	1	1	1	10	10	1	6	6	-3	-3	-3	6	6	-3
3749	5	10	1	2	2	2	10	3	1	5	-4	-3	-3	-3	5	-2	-4
3754	2	10	10	2	2	2	10	10	1	8	8	0	0	0	8	8	-1
3756	2	10	2	2	2	2	10	10	1	8	0	0	0	0	8	8	-1
3758	5	10	10	5	5	5	10	10	1	5	5	0	0	0	5	5	-4
3763	1	10	9	1	1	1	10	9	1	9	8	0	0	0	9	8	0
3764	2	10	7	1	1	1	10	10	2	8	5	-1	-1	-1	8	8	0
3766	1	10	1	1	1	1	10	10	1	9	0	0	0	0	9	9	0
3767	2	10	4	2	2	2	10	4	2	8	2	0	0	0	8	2	0
3769	2	10	6	2	2	2	10	4	1	8	4	0	0	0	8	2	-1
3771	3	10	8	2	2	2	10	10	3	7	5	-1	-1	-1	7	7	0
3774	2	10	9	1	1	1	10	10	2	8	7	-1	-1	-1	8	8	0
3776	1	10	1	1	1	1	10	1	2	9	0	0	0	0	9	0	1
3777	1	10	4	1	1	1	10	10	1	9	3	0	0	0	9	9	0
3778	1	10	6	0	0	0	10	10	2	9	5	-1	-1	-1	9	9	1
3779	5	10	4	3	3	3	10	10	2	5	-1	-2	-2	-2	5	5	-3
3784	2	10	4	1	1	1	10	10	4	8	2	-1	-1	-1	8	8	2
3786	2	10	2	1	1	1	10	10	4	8	0	-1	-1	-1	8	8	2
3788	4	10	3	3	3	3	10	10	1	6	-1	-1	-1	-1	6	6	-3
3792	2	10	2	2	2	2	10	10	1	8	0	0	0	0	8	8	-1
3794	2	10	5	0	0	0	10	2	2	8	3	-2	-2	-2	8	0	0
3796	4	10	10	2	2	2	10	10	3	6	6	-2	-2	-2	6	6	-1
3800	3	10	1	3	3	3	10	2	2	7	-2	0	0	0	7	-1	-1
3803	3	10	10	3	3	3	10	10	1	7	7	0	0	0	7	7	-2
3806	3	10	1	3	3	3	10	1	4	7	-2	0	0	0	7	-2	1
3809	3	10	1	3	3	3	10	4	2	7	-2	0	0	0	7	1	-1
3812	1	10	10	1	1	1	10	10	2	9	9	0	0	0	9	9	1
3813	1	10	1	1	1	1	10	10	4	9	0	0	0	0	9	9	3
3814	7	10	5	4	4	4	10	10	1	3	-2	-3	-3	-3	3	3	-6
3821	2	10	3	2	2	2	10	7	2	8	1	0	0	0	8	5	0
3823	2	10	2	0	0	0	10	10	2	8	0	-2	-2	-2	8	8	0
3825	6	10	5	3	3	3	10	10	2	4	-1	-3	-3	-3	4	4	-4
3831	4	10	4	2	2	2	10	10	5	6	0	-2	-2	-2	6	6	1
3835	2	10	10	1	1	1	10	10	3	8	8	-1	-1	-1	8	8	1
3837	2	10	10	1	2	2	10	10	2	8	8	-1	0	0	8	8	0
3839	2	10	1	2	2	2	10	10	8	8	-1	0	0	0	8	8	6
3841	4	10	10	2	2	2	10	10	2	6	6	-2	-2	-2	6	6	-2
3845	4	10	1	1	1	1	10	10	1	6	-3	-3	-3	-3	6	6	-3
3849	5	10	2	2	2	2	10	10	1	5	-3	-3	-3	-3	5	5	-4
3854	1	10	10	1	1	1	10	6	1	9	9	0	0	0	9	5	0
3855	1	10	3	0	0	0	10	1	1	9	2	-1	-1	-1	9	0	0
3856	2	10	1	1	1	1	10	2	2	8	-1	-1	-1	-1	8	0	0
3858	1	10	4	1	1	1	10	4	3	9	3	0	0	0	9	3	2
3859	2	10	6	0	0	0	10	10	3	8	4	-2	-2	-2	8	8	1
3861	2	10	1	1	1	1	10	2	1	8	-1	-1	-1	-1	8	0	-1
3863	6	10	2	1	1	1	10	2	2	4	-4	-5	-5	-5	4	-4	-4
3869	2	10	4	2	2	2	10	5	5	8	2	0	0	0	8	3	3
3871	1	0	0	0	0	0	10	3	1	-1	-1	-1	-1	-1	9	2	0
3872	2	10	1	1	1	1	10	10	1	8	-1	-1	-1	-1	8	8	-1
3874	2	10	1	1	1	1	10	10	2	8	-1	-1	-1	-1	8	8	0
3876	4	10	2	2	2	2	10	2	2	6	-2	-2	-2	-2	6	-2	-2
3880	3	10	1	2	2	2	10	10	1	7	-2	-1	-1	-1	7	7	-2
3883	2	10	1	2	2	2	10	1	2	8	-1	0	0	0	8	-1	0
3885	2	10	4	2	2	2	10	1	2	8	2	0	0	0	8	-1	0
3887	1	10	9	1	1	1	10	1	4	9	8	0	0	0	9	0	3
3888	1	10	2	1	1	1	10	2	3	9	1	0	0	0	9	1	2
3889	2	10	1	2	2	2	10	3	3	8	-1	0	0	0	8	1	1
3891	1	10	1	1	1	1	10	3	4	9	0	0	0	0	9	2	3
3892	2	10	1	2	2	2	10	10	1	8	-1	0	0	0	8	8	-1
3894	3	10	10	2	2	2	10	10	6	7	7	-1	-1	-1	7	7	3
3897	3	10	3	2	2	2	10	10	4	7	0	-1	-1	-1	7	7	1
3900	2	10	2	2	2	2	10	9	3	8	0	0	0	0	8	7	1
3902	1	10	4	0	0	0	10	9	2	9	3	-1	-1	-1	9	8	1
3903	3	10	1	3	3	3	10	10	2	7	-2	0	0	0	7	7	-1
3906	1	10	3	1	1	1	10	6	1	9	2	0	0	0	9	5	0
3907	2	10	1	1	1	1	10	4	2	8	-1	-1	-1	-1	8	2	0
3909	2	10	2	2	2	2	10	10	1	8	0	0	0	0	8	8	-1
3911	2	10	10	1	1	1	10	3	2	8	8	-1	-1	-1	8	1	0
3913	4	10	10	2	2	2	10	10	3	6	6	-2	-2	-2	6	6	-1
3917	2	10	9	2	2	2	10	10	1	8	7	0	0	0	8	8	-1
3919	1	10	10	0	0	0	10	10	2	9	9	-1	-1	-1	9	9	1
3920	1	7	1	0	0	0	10	1	1	6	0	-1	-1	-1	9	0	0
3921	3	10	2	1	1	1	10	10	1	7	-1	-2	-2	-2	7	7	-2
3924	1	10	3	1	1	1	10	10	2	9	2	0	0	0	9	9	1
3925	2	10	3	1	1	1	10	3	3	8	1	-1	-1	-1	8	1	1
3927	4	10	10	2	2	2	10	10	2	6	6	-2	-2	-2	6	6	-2
3931	1	10	3	0	0	0	10	3	2	9	2	-1	-1	-1	9	2	1
3932	1	10	9	1	1	1	10	10	1	9	8	0	0	0	9	9	0
3933	1	10	3	1	1	1	10	10	2	9	2	0	0	0	9	9	1
3934	1	10	4	0	0	0	10	10	4	9	3	-1	-1	-1	9	9	3
3935	1	10	3	1	1	1	10	2	1	9	2	0	0	0	9	1	0
3936	2	10	3	0	0	0	10	10	3	8	1	-2	-2	-2	8	8	1
3938	4	10	3	2	2	2	10	4	6	6	-1	-2	-2	-2	6	0	2
3942	1	10	10	1	1	1	10	10	4	9	9	0	0	0	9	9	3
3943	2	10	1	0	0	0	10	10	1	8	-1	-2	-2	-2	8	8	-1
3945	3	10	1	2	2	2	10	10	2	7	-2	-1	-1	-1	7	7	-1
3948	4	10	10	1	1	1	10	10	2	6	6	-3	-3	-3	6	6	-2
3952	1	10	6	1	1	1	10	10	2	9	5	0	0	0	9	9	1
3953	1	10	10	1	1	1	10	10	1	9	9	0	0	0	9	9	0
3954	2	10	4	2	2	2	10	1	3	8	2	0	0	0	8	-1	1
3956	1	10	6	1	1	1	9	10	1	9	5	0	0	0	8	9	0
3957	3	10	1	2	2	2	10	10	2	7	-2	-1	-1	-1	7	7	-1
3960	3	10	3	2	2	2	10	10	8	7	0	-1	-1	-1	7	7	5
3963	1	10	2	1	1	1	10	1	2	9	1	0	0	0	9	0	1
3964	3	10	2	3	3	3	10	8	5	7	-1	0	0	0	7	5	2
3967	3	10	7	1	1	1	10	3	2	7	4	-2	-2	-2	7	0	-1
3970	1	10	3	1	1	1	10	3	3	9	2	0	0	0	9	2	2
3971	2	10	1	2	2	2	10	1	2	8	-1	0	0	0	8	-1	0
3973	1	10	3	1	1	1	10	3	2	9	2	0	0	0	9	2	1
3974	2	10	8	2	2	2	10	9	6	8	6	0	0	0	8	7	4
3976	1	10	4	1	1	1	10	4	3	9	3	0	0	0	9	3	2
3977	1	10	3	0	0	0	10	6	3	9	2	-1	-1	-1	9	5	2
3978	1	10	10	1	1	1	10	10	2	9	9	0	0	0	9	9	1
3979	3	10	6	2	2	2	10	10	1	7	3	-1	-1	-1	7	7	-2
3982	3	10	2	3	3	3	10	10	2	7	-1	0	0	0	7	7	-1
3985	1	10	1	1	1	1	10	1	1	9	0	0	0	0	9	0	0
3986	1	10	10	0	0	0	10	10	5	9	9	-1	-1	-1	9	9	4
3987	1	10	3	1	1	1	10	3	1	9	2	0	0	0	9	2	0
3988	5	10	10	1	1	1	10	10	1	5	5	-4	-4	-4	5	5	-4
3993	3	10	1	1	1	1	10	10	3	7	-2	-2	-2	-2	7	7	0
3996	1	10	10	1	1	1	10	10	1	9	9	0	0	0	9	9	0
3997	3	10	1	2	2	2	10	10	4	7	-2	-1	-1	-1	7	7	1
4000	2	10	10	2	2	2	10	1	1	8	8	0	0	0	8	-1	-1
4002	2	10	8	1	1	1	10	10	2	8	6	-1	-1	-1	8	8	0
4004	1	10	3	1	1	1	10	6	2	9	2	0	0	0	9	5	1
4005	3	10	1	3	3	3	10	10	2	7	-2	0	0	0	7	7	-1
4008	2	10	6	1	1	1	10	8	4	8	4	-1	-1	-1	8	6	2
4010	1	10	1	1	1	1	10	1	1	9	0	0	0	0	9	0	0
4011	1	10	1	1	1	1	10	1	2	9	0	0	0	0	9	0	1
4012	1	10	1	1	1	1	10	1	1	9	0	0	0	0	9	0	0
4013	3	10	6	3	3	3	10	10	6	7	3	0	0	0	7	7	3
4016	2	10	8	2	2	2	10	6	3	8	6	0	0	0	8	4	1
4018	1	10	3	1	1	1	10	3	3	9	2	0	0	0	9	2	2
4019	2	10	10	1	1	1	10	10	5	8	8	-1	-1	-1	8	8	3
4021	2	6	1	2	2	2	10	1	2	4	-1	0	0	0	8	-1	0
4023	4	10	2	2	2	2	10	10	1	6	-2	-2	-2	-2	6	6	-3
4027	2	10	1	1	1	1	10	3	1	8	-1	-1	-1	-1	8	1	-1
4029	1	10	3	1	1	1	10	4	1	9	2	0	0	0	9	3	0
4030	2	10	1	1	1	1	10	1	1	8	-1	-1	-1	-1	8	-1	-1
4032	4	10	10	1	1	1	10	10	2	6	6	-3	-3	-3	6	6	-2
4036	1	10	6	1	1	1	10	10	1	9	5	0	0	0	9	9	0
4037	5	10	4	3	3	3	10	10	1	5	-1	-2	-2	-2	5	5	-4
4042	1	10	3	1	1	1	9	1	1	9	2	0	0	0	8	0	0
4043	1	10	10	1	1	1	10	10	2	9	9	0	0	0	9	9	1
4044	2	10	6	2	2	2	10	3	1	8	4	0	0	0	8	1	-1
4046	3	10	10	2	2	2	10	10	2	7	7	-1	-1	-1	7	7	-1
4049	1	10	6	0	0	0	7	10	2	9	5	-1	-1	-1	6	9	1
4050	2	10	3	1	1	1	10	3	1	8	1	-1	-1	-1	8	1	-1
4052	4	10	2	3	2	3	10	1	8	6	-2	-1	-2	-1	6	-3	4
4056	1	10	1	1	1	1	10	1	7	9	0	0	0	0	9	0	6
4057	1	10	1	1	1	1	10	3	3	9	0	0	0	0	9	2	2
4058	1	10	10	1	1	1	10	9	2	9	9	0	0	0	9	8	1
4059	1	7	1	1	1	1	10	1	2	6	0	0	0	0	9	0	1
4060	2	10	1	2	2	2	10	10	5	8	-1	0	0	0	8	8	3
4062	5	10	6	0	0	0	10	10	2	5	1	-5	-5	-5	5	5	-3
4067	1	9	1	0	0	0	10	7	1	8	0	-1	-1	-1	9	6	0
4068	4	10	3	1	1	1	10	1	2	6	-1	-3	-3	-3	6	-3	-2
4072	1	10	3	0	0	0	10	4	3	9	2	-1	-1	-1	9	3	2
4073	2	10	1	0	0	0	10	1	1	8	-1	-2	-2	-2	8	-1	-1
4075	5	10	4	5	5	5	10	4	1	5	-1	0	0	0	5	-1	-4
4080	5	10	6	2	2	2	10	10	1	5	1	-3	-3	-3	5	5	-4
4085	3	10	10	1	1	1	10	10	3	7	7	-2	-2	-2	7	7	0
4088	1	10	8	0	0	0	10	5	2	9	7	-1	-1	-1	9	4	1
4089	5	10	1	3	3	3	10	10	5	5	-4	-2	-2	-2	5	5	0
4094	3	10	1	2	2	2	10	10	1	7	-2	-1	-1	-1	7	7	-2
4097	2	10	1	2	2	2	10	1	1	8	-1	0	0	0	8	-1	-1
4099	1	10	1	1	1	1	10	4	2	9	0	0	0	0	9	3	1
4100	1	10	4	1	1	1	10	10	4	9	3	0	0	0	9	9	3
4101	6	10	4	4	4	4	10	3	3	4	-2	-2	-2	-2	4	-3	-3
4107	3	10	6	1	1	1	10	3	3	7	3	-2	-2	-2	7	0	0
4110	1	10	1	1	1	1	10	4	3	9	0	0	0	0	9	3	2
4111	1	10	10	1	1	1	10	10	2	9	9	0	0	0	9	9	1
4112	2	10	1	1	1	1	10	10	3	8	-1	-1	-1	-1	8	8	1
4114	1	7	1	0	0	0	10	1	3	6	0	-1	-1	-1	9	0	2
4115	1	0	0	0	0	0	10	10	7	-1	-1	-1	-1	-1	9	9	6
4116	1	10	1	1	1	1	10	4	3	9	0	0	0	0	9	3	2
4117	1	10	3	1	1	1	10	3	1	9	2	0	0	0	9	2	0
4118	3	10	10	1	1	1	10	9	3	7	7	-2	-2	-2	7	6	0
4121	1	10	2	1	1	1	10	3	5	9	1	0	0	0	9	2	4
4122	3	10	3	2	2	2	10	1	4	7	0	-1	-1	-1	7	-2	1
4125	2	10	2	2	2	2	10	10	1	8	0	0	0	0	8	8	-1
4127	1	10	2	1	1	1	10	1	2	9	1	0	0	0	9	0	1
4128	1	10	3	1	1	1	10	1	1	9	2	0	0	0	9	0	0
4129	3	10	3	3	3	3	10	10	1	7	0	0	0	0	7	7	-2
4132	7	10	9	4	4	4	10	10	4	3	2	-3	-3	-3	3	3	-3
4139	6	10	3	5	5	5	10	10	1	4	-3	-1	-1	-1	4	4	-5
4145	1	10	8	1	1	1	10	6	2	9	7	0	0	0	9	5	1
4146	6	10	10	4	3	3	10	10	3	4	4	-2	-3	-3	4	4	-3
4152	1	10	3	1	1	1	10	10	1	9	2	0	0	0	9	9	0
4153	2	10	4	2	2	2	10	10	3	8	2	0	0	0	8	8	1
4155	1	10	3	0	0	0	10	3	1	9	2	-1	-1	-1	9	2	0
4156	1	10	3	1	1	1	10	1	1	9	2	0	0	0	9	0	0
4157	1	10	3	1	1	1	10	1	1	9	2	0	0	0	9	0	0
4158	1	10	5	1	1	1	10	4	1	9	4	0	0	0	9	3	0
4159	2	10	10	1	1	1	10	9	3	8	8	-1	-1	-1	8	7	1
4161	1	10	10	1	1	1	10	10	1	9	9	0	0	0	9	9	0
4162	4	10	6	1	1	1	10	10	3	6	2	-3	-3	-3	6	6	-1
4166	1	10	3	1	1	1	10	4	1	9	2	0	0	0	9	3	0
4167	1	10	1	1	1	1	10	2	2	9	0	0	0	0	9	1	1
4168	2	10	9	1	1	1	10	3	3	8	7	-1	-1	-1	8	1	1
4170	3	10	10	2	2	2	10	9	1	7	7	-1	-1	-1	7	6	-2
4173	2	10	5	1	1	1	10	5	1	8	3	-1	-1	-1	8	3	-1
4175	1	10	1	1	1	1	10	1	2	9	0	0	0	0	9	0	1
4176	2	10	2	0	0	0	10	1	2	8	0	-2	-2	-2	8	-1	0
4178	1	10	1	1	1	1	10	2	2	9	0	0	0	0	9	1	1
4179	2	10	6	1	1	1	10	10	1	8	4	-1	-1	-1	8	8	-1
4181	5	10	7	4	4	4	10	8	3	5	2	-1	-1	-1	5	3	-2
4186	8	10	10	7	7	7	10	10	1	2	2	-1	-1	-1	2	2	-7
4194	3	10	1	2	2	2	10	10	1	7	-2	-1	-1	-1	7	7	-2
4197	1	10	3	1	1	1	10	7	1	9	2	0	0	0	9	6	0
4198	6	10	10	2	2	2	10	10	2	4	4	-4	-4	-4	4	4	-4
4204	1	10	3	1	1	1	10	10	3	9	2	0	0	0	9	9	2
4205	2	3	1	0	0	0	10	9	1	1	-1	-2	-2	-2	8	7	-1
4207	6	10	1	4	4	4	10	10	1	4	-5	-2	-2	-2	4	4	-5
4213	5	10	10	2	2	2	10	10	3	5	5	-3	-3	-3	5	5	-2
4218	1	10	10	0	0	0	10	10	2	9	9	-1	-1	-1	9	9	1
4219	2	10	1	2	2	2	10	10	3	8	-1	0	0	0	8	8	1
4221	3	10	10	2	2	2	10	10	4	7	7	-1	-1	-1	7	7	1
4224	2	10	1	2	2	2	10	8	2	8	-1	0	0	0	8	6	0
4226	1	10	3	1	1	1	10	4	1	9	2	0	0	0	9	3	0
4227	2	10	1	0	0	0	10	1	3	8	-1	-2	-2	-2	8	-1	1
4229	4	10	1	2	2	2	10	1	6	6	-3	-2	-2	-2	6	-3	2
4233	1	10	1	1	1	1	10	1	2	9	0	0	0	0	9	0	1
4234	3	10	4	3	3	3	10	4	2	7	1	0	0	0	7	1	-1
4237	3	10	2	2	2	2	10	10	4	7	-1	-1	-1	-1	7	7	1
4240	1	10	1	0	0	0	10	3	2	9	0	-1	-1	-1	9	2	1
4241	3	10	1	3	3	3	10	4	2	7	-2	0	0	0	7	1	-1
4244	5	10	1	2	2	2	10	10	1	5	-4	-3	-3	-3	5	5	-4
4249	1	10	4	1	1	1	10	10	2	9	3	0	0	0	9	9	1
4250	3	10	1	3	3	3	10	3	1	7	-2	0	0	0	7	0	-2
4253	3	10	3	2	2	2	10	3	3	7	0	-1	-1	-1	7	0	0
4256	3	10	9	1	1	1	10	10	1	7	6	-2	-2	-2	7	7	-2
4259	2	10	1	1	1	1	10	1	4	8	-1	-1	-1	-1	8	-1	2
4261	3	10	6	2	2	2	10	10	1	7	3	-1	-1	-1	7	7	-2
4264	2	10	2	2	2	2	10	10	2	8	0	0	0	0	8	8	0
4266	1	10	10	1	1	1	10	10	1	9	9	0	0	0	9	9	0
4267	3	10	6	3	3	3	10	8	1	7	3	0	0	0	7	5	-2
4270	3	10	2	3	3	3	10	1	1	7	-1	0	0	0	7	-2	-2
4273	1	10	2	1	1	1	10	1	3	9	1	0	0	0	9	0	2
4274	2	10	2	2	2	2	10	10	1	8	0	0	0	0	8	8	-1
4276	3	10	1	3	3	3	10	1	1	7	-2	0	0	0	7	-2	-2
4279	1	10	3	1	1	1	10	3	3	9	2	0	0	0	9	2	2
4280	2	10	4	2	2	2	10	6	2	8	2	0	0	0	8	4	0
4282	1	10	10	1	1	1	10	2	2	9	9	0	0	0	9	1	1
4283	1	10	6	1	1	1	10	10	1	9	5	0	0	0	9	9	0
4284	1	10	2	1	1	1	10	10	4	9	1	0	0	0	9	9	3
4285	1	10	1	0	0	0	10	1	2	9	0	-1	-1	-1	9	0	1
4286	1	10	4	1	1	1	10	10	2	9	3	0	0	0	9	9	1
4287	4	10	1	2	3	3	10	10	1	6	-3	-2	-1	-1	6	6	-3
4291	3	10	2	2	3	3	10	3	3	7	-1	-1	0	0	7	0	0
4294	2	10	5	2	2	2	10	10	1	8	3	0	0	0	8	8	-1
4296	6	10	10	3	3	3	10	10	1	4	4	-3	-3	-3	4	4	-5
4302	1	10	1	1	1	1	10	7	3	9	0	0	0	0	9	6	2
4303	1	10	2	0	0	0	10	1	2	9	1	-1	-1	-1	9	0	1
4304	5	10	2	3	3	3	10	1	1	5	-3	-2	-2	-2	5	-4	-4
4309	4	10	3	3	3	3	10	1	2	6	-1	-1	-1	-1	6	-3	-2
4313	1	10	1	1	1	1	9	1	3	9	0	0	0	0	8	0	2
4314	2	10	2	1	1	1	10	9	2	8	0	-1	-1	-1	8	7	0
4316	3	10	2	3	3	3	10	10	1	7	-1	0	0	0	7	7	-2
4319	3	10	2	3	3	3	10	1	4	7	-1	0	0	0	7	-2	1
4322	2	10	2	1	1	1	10	10	3	8	0	-1	-1	-1	8	8	1
4324	3	10	3	1	1	1	10	10	3	7	0	-2	-2	-2	7	7	0
4327	4	10	3	3	3	3	10	10	3	6	-1	-1	-1	-1	6	6	-1
4331	1	10	4	1	1	1	10	6	1	9	3	0	0	0	9	5	0
4332	2	10	1	0	0	0	10	1	2	8	-1	-2	-2	-2	8	-1	0
4334	1	10	10	1	1	1	10	10	2	9	9	0	0	0	9	9	1
4335	2	10	2	0	0	0	10	1	1	8	0	-2	-2	-2	8	-1	-1
4337	1	10	1	1	1	1	10	2	3	9	0	0	0	0	9	1	2
4338	1	10	4	1	1	1	10	10	2	9	3	0	0	0	9	9	1
4339	1	10	1	1	1	1	10	4	2	9	0	0	0	0	9	3	1
4340	1	10	6	1	1	1	10	4	1	9	5	0	0	0	9	3	0
4341	4	10	10	1	1	1	10	10	3	6	6	-3	-3	-3	6	6	-1
4345	4	10	2	2	2	2	10	9	1	6	-2	-2	-2	-2	6	5	-3
4349	2	10	1	1	1	1	10	9	2	8	-1	-1	-1	-1	8	7	0
4351	4	10	4	0	0	0	10	10	1	6	0	-4	-4	-4	6	6	-3
4355	1	10	6	1	1	1	10	2	1	9	5	0	0	0	9	1	0
4356	1	10	3	1	1	1	10	2	2	9	2	0	0	0	9	1	1
4357	2	10	2	1	1	1	10	10	1	8	0	-1	-1	-1	8	8	-1
4359	1	10	1	1	1	1	10	6	2	9	0	0	0	0	9	5	1
4360	2	10	10	2	2	2	10	10	2	8	8	0	0	0	8	8	0
4362	2	5	1	0	0	0	10	4	1	3	-1	-2	-2	-2	8	2	-1
4364	1	10	2	1	1	1	10	1	1	9	1	0	0	0	9	0	0
4365	1	10	2	1	1	1	10	1	1	9	1	0	0	0	9	0	0
4366	4	10	10	4	4	4	10	10	1	6	6	0	0	0	6	6	-3
4370	2	10	2	0	0	0	10	1	2	8	0	-2	-2	-2	8	-1	0
4372	2	10	1	1	1	1	10	6	2	8	-1	-1	-1	-1	8	4	0
4374	2	10	4	1	1	1	10	10	3	8	2	-1	-1	-1	8	8	1
4376	3	10	1	2	2	2	10	10	1	7	-2	-1	-1	-1	7	7	-2
4379	1	10	4	1	1	1	10	10	1	9	3	0	0	0	9	9	0
4380	2	10	2	1	1	1	10	10	1	8	0	-1	-1	-1	8	8	-1
4382	3	10	4	2	2	2	10	7	1	7	1	-1	-1	-1	7	4	-2
4385	6	10	6	5	5	5	10	7	1	4	0	-1	-1	-1	4	1	-5
4391	1	10	2	1	1	1	10	10	2	9	1	0	0	0	9	9	1
4392	3	10	10	2	2	2	10	6	3	7	7	-1	-1	-1	7	3	0
4395	2	10	2	0	0	0	10	10	2	8	0	-2	-2	-2	8	8	0
4397	1	1	1	0	0	0	10	7	4	0	0	-1	-1	-1	9	6	3
4398	2	10	6	2	2	2	10	10	1	8	4	0	0	0	8	8	-1
4400	2	10	8	1	1	1	10	7	2	8	6	-1	-1	-1	8	5	0
4402	3	10	9	1	1	1	10	10	4	7	6	-2	-2	-2	7	7	1
4405	1	10	10	1	1	1	10	10	2	9	9	0	0	0	9	9	1
4406	1	10	1	1	1	1	10	8	4	9	0	0	0	0	9	7	3
4407	1	10	10	1	1	1	10	10	2	9	9	0	0	0	9	9	1
4408	5	10	10	3	3	3	10	3	3	5	5	-2	-2	-2	5	-2	-2
4413	3	10	2	1	1	1	10	5	1	7	-1	-2	-2	-2	7	2	-2
4416	2	10	10	1	1	1	10	10	1	8	8	-1	-1	-1	8	8	-1
4418	4	10	10	2	2	2	10	10	2	6	6	-2	-2	-2	6	6	-2
4422	1	10	10	1	1	1	10	10	3	9	9	0	0	0	9	9	2
4423	2	10	10	2	2	2	10	10	3	8	8	0	0	0	8	8	1
4425	2	10	1	1	1	1	10	2	4	8	-1	-1	-1	-1	8	0	2
4427	2	10	3	2	2	2	10	8	1	8	1	0	0	0	8	6	-1
4429	4	10	3	2	2	2	10	10	2	6	-1	-2	-2	-2	6	6	-2
4433	1	10	10	1	1	1	10	10	1	9	9	0	0	0	9	9	0
4434	4	10	4	1	1	1	10	10	3	6	0	-3	-3	-3	6	6	-1
4438	2	10	3	1	1	1	10	9	1	8	1	-1	-1	-1	8	7	-1
4440	3	10	9	1	1	1	10	3	3	7	6	-2	-2	-2	7	0	0
4443	2	10	3	1	1	1	10	2	2	8	1	-1	-1	-1	8	0	0
4445	1	10	10	1	1	1	10	10	3	9	9	0	0	0	9	9	2
4446	6	10	3	1	1	1	10	10	10	4	-3	-5	-5	-5	4	4	4
4452	2	10	1	1	1	1	10	1	2	8	-1	-1	-1	-1	8	-1	0
4454	2	10	2	1	1	1	10	10	2	8	0	-1	-1	-1	8	8	0
4456	3	10	1	3	3	3	10	4	3	7	-2	0	0	0	7	1	0
4459	5	10	2	2	2	2	10	1	2	5	-3	-3	-3	-3	5	-4	-3
4464	3	10	10	1	1	1	10	10	1	7	7	-2	-2	-2	7	7	-2
4467	2	10	1	2	2	2	10	10	1	8	-1	0	0	0	8	8	-1
4469	7	10	10	0	0	0	10	10	1	3	3	-7	-7	-7	3	3	-6
4476	2	10	1	1	1	1	10	10	3	8	-1	-1	-1	-1	8	8	1
4478	1	10	10	0	0	0	10	6	1	9	9	-1	-1	-1	9	5	0
4479	2	10	1	1	1	1	10	1	2	8	-1	-1	-1	-1	8	-1	0
4481	1	10	10	1	1	1	10	10	2	9	9	0	0	0	9	9	1
4482	2	10	1	1	1	1	10	2	7	8	-1	-1	-1	-1	8	0	5
4484	2	10	2	0	0	0	10	1	1	8	0	-2	-2	-2	8	-1	-1
4486	1	10	1	1	1	1	10	1	1	9	0	0	0	0	9	0	0
4487	2	10	3	1	1	1	10	1	2	8	1	-1	-1	-1	8	-1	0
4489	2	10	1	1	1	1	10	2	2	8	-1	-1	-1	-1	8	0	0
4491	4	10	5	4	4	4	10	8	7	6	1	0	0	0	6	4	3
4495	2	10	2	1	1	1	10	2	2	8	0	-1	-1	-1	8	0	0
4497	1	10	6	1	1	1	10	7	3	9	5	0	0	0	9	6	2
4498	1	10	10	1	1	1	10	3	3	9	9	0	0	0	9	2	2
4499	2	10	10	2	2	2	10	4	1	8	8	0	0	0	8	2	-1
4501	1	10	4	1	1	1	10	4	4	9	3	0	0	0	9	3	3
4502	3	10	10	2	2	2	10	4	2	7	7	-1	-1	-1	7	1	-1
4505	2	10	4	1	1	1	10	9	2	8	2	-1	-1	-1	8	7	0
4507	2	10	1	1	2	2	10	2	3	8	-1	-1	0	0	8	0	1
4509	2	10	3	2	2	2	10	10	1	8	1	0	0	0	8	8	-1
4511	1	10	4	1	1	1	10	10	2	9	3	0	0	0	9	9	1
4512	2	10	10	1	2	2	10	10	2	8	8	-1	0	0	8	8	0
4514	5	10	2	0	0	0	10	1	2	5	-3	-5	-5	-5	5	-4	-3
4519	1	10	4	1	1	1	10	10	3	9	3	0	0	0	9	9	2
4520	2	10	2	2	2	2	10	10	1	8	0	0	0	0	8	8	-1
4522	4	10	3	1	1	1	10	10	1	6	-1	-3	-3	-3	6	6	-3
4526	1	10	10	1	1	1	10	4	1	9	9	0	0	0	9	3	0
4527	3	10	10	2	2	2	10	6	2	7	7	-1	-1	-1	7	3	-1
4530	5	10	3	0	0	0	10	7	2	5	-2	-5	-5	-5	5	2	-3
4535	1	10	2	0	0	0	10	10	3	9	1	-1	-1	-1	9	9	2
4536	1	10	10	1	1	1	10	10	4	9	9	0	0	0	9	9	3
4537	1	10	3	1	1	1	10	4	2	9	2	0	0	0	9	3	1
4538	5	10	1	1	1	1	10	10	2	5	-4	-4	-4	-4	5	5	-3
4543	4	10	2	4	4	4	10	2	5	6	-2	0	0	0	6	-2	1
4547	1	10	7	1	1	1	10	6	4	9	6	0	0	0	9	5	3
4548	5	10	2	3	3	3	10	9	1	5	-3	-2	-2	-2	5	4	-4
4553	1	10	10	1	1	1	10	6	1	9	9	0	0	0	9	5	0
4554	3	10	10	2	2	2	10	2	3	7	7	-1	-1	-1	7	-1	0
4557	4	10	1	0	0	0	10	10	2	6	-3	-4	-4	-4	6	6	-2
4561	2	10	10	0	0	0	10	10	2	8	8	-2	-2	-2	8	8	0
4563	1	10	10	1	1	1	10	10	8	9	9	0	0	0	9	9	7
4564	2	10	3	2	2	2	10	1	3	8	1	0	0	0	8	-1	1
4566	2	10	3	2	2	2	10	4	2	8	1	0	0	0	8	2	0
4568	1	10	1	1	1	1	10	10	4	9	0	0	0	0	9	9	3
4569	1	10	3	1	1	1	10	3	6	9	2	0	0	0	9	2	5
4570	1	10	3	1	1	1	10	1	2	9	2	0	0	0	9	0	1
4571	1	10	9	0	0	0	10	9	1	9	8	-1	-1	-1	9	8	0
4572	8	10	10	4	4	4	10	10	1	2	2	-4	-4	-4	2	2	-7
4580	2	10	6	2	2	2	10	4	2	8	4	0	0	0	8	2	0
4582	1	10	6	0	0	0	8	5	2	9	5	-1	-1	-1	7	4	1
4583	6	10	10	3	3	3	10	10	2	4	4	-3	-3	-3	4	4	-4
4589	5	10	2	3	3	3	10	10	2	5	-3	-2	-2	-2	5	5	-3
4594	6	10	10	3	3	3	10	10	4	4	4	-3	-3	-3	4	4	-2
4600	4	10	10	3	2	2	10	6	2	6	6	-1	-2	-2	6	2	-2
4604	1	10	1	1	1	1	10	1	4	9	0	0	0	0	9	0	3
4605	3	10	10	1	1	1	10	10	1	7	7	-2	-2	-2	7	7	-2
4608	3	10	8	2	2	2	10	3	1	7	5	-1	-1	-1	7	0	-2
4611	1	10	4	1	1	1	10	10	2	9	3	0	0	0	9	9	1
4612	1	10	10	1	1	1	10	4	1	9	9	0	0	0	9	3	0
4613	4	10	2	1	1	1	10	10	2	6	-2	-3	-3	-3	6	6	-2
4617	1	10	1	1	1	1	10	4	1	9	0	0	0	0	9	3	0
4618	1	10	1	1	1	1	10	6	2	9	0	0	0	0	9	5	1
4619	4	10	2	0	0	0	10	8	1	6	-2	-4	-4	-4	6	4	-3
4623	3	10	2	2	2	2	10	8	3	7	-1	-1	-1	-1	7	5	0
4626	1	10	10	0	0	0	10	10	2	9	9	-1	-1	-1	9	9	1
4627	2	10	1	2	2	2	10	10	1	8	-1	0	0	0	8	8	-1
4629	1	10	1	1	1	1	10	8	1	9	0	0	0	0	9	7	0
4630	2	10	2	2	2	2	10	1	3	8	0	0	0	0	8	-1	1
4632	4	10	10	2	2	2	10	10	2	6	6	-2	-2	-2	6	6	-2
4636	2	10	1	2	2	2	10	9	1	8	-1	0	0	0	8	7	-1
4638	3	10	10	2	2	2	10	10	1	7	7	-1	-1	-1	7	7	-2
4641	4	10	10	3	3	3	10	10	1	6	6	-1	-1	-1	6	6	-3
4645	1	0	0	0	0	0	10	1	2	-1	-1	-1	-1	-1	9	0	1
4646	2	10	6	2	2	2	10	10	3	8	4	0	0	0	8	8	1
4648	3	10	3	1	1	1	10	10	1	7	0	-2	-2	-2	7	7	-2
4651	2	10	2	2	2	2	10	1	2	8	0	0	0	0	8	-1	0
4653	2	10	3	2	2	2	10	10	4	8	1	0	0	0	8	8	2
4655	3	10	10	3	3	3	10	10	1	7	7	0	0	0	7	7	-2
4658	1	10	8	1	1	1	10	7	6	9	7	0	0	0	9	6	5
4659	2	10	9	2	2	2	10	10	7	8	7	0	0	0	8	8	5
4661	1	10	10	1	1	1	10	10	2	9	9	0	0	0	9	9	1
4662	4	10	10	2	2	2	10	10	1	6	6	-2	-2	-2	6	6	-3
4666	2	10	5	1	1	1	10	10	1	8	3	-1	-1	-1	8	8	-1
4668	1	10	2	1	1	1	10	1	3	9	1	0	0	0	9	0	2
4669	2	10	2	2	2	2	10	2	1	8	0	0	0	0	8	0	-1
4671	4	10	10	4	4	4	10	6	4	6	6	0	0	0	6	2	0
4675	5	10	4	1	1	1	10	6	5	5	-1	-4	-4	-4	5	1	0
4680	2	10	10	2	2	2	10	10	1	8	8	0	0	0	8	8	-1
4682	1	10	1	1	1	1	10	1	1	9	0	0	0	0	9	0	0
4683	1	10	6	0	0	0	10	10	4	9	5	-1	-1	-1	9	9	3
4684	2	10	2	1	1	1	10	1	2	8	0	-1	-1	-1	8	-1	0
4686	4	10	6	2	3	3	10	10	4	6	2	-2	-1	-1	6	6	0
4690	2	10	10	2	2	2	10	10	2	8	8	0	0	0	8	8	0
4692	2	10	2	0	0	0	10	9	2	8	0	-2	-2	-2	8	7	0
4694	1	10	2	1	1	1	10	1	3	9	1	0	0	0	9	0	2
4695	2	10	2	1	1	1	10	6	1	8	0	-1	-1	-1	8	4	-1
4697	4	10	10	1	1	1	10	10	2	6	6	-3	-3	-3	6	6	-2
4701	2	10	1	1	1	1	10	2	3	8	-1	-1	-1	-1	8	0	1
4703	2	10	1	2	2	2	10	1	2	8	-1	0	0	0	8	-1	0
4705	3	10	1	2	2	2	10	10	1	7	-2	-1	-1	-1	7	7	-2
4708	2	10	2	2	2	2	10	1	1	8	0	0	0	0	8	-1	-1
4710	2	7	3	0	0	0	10	3	4	5	1	-2	-2	-2	8	1	2
4712	2	10	6	1	1	1	10	10	3	8	4	-1	-1	-1	8	8	1
4714	4	10	1	1	1	1	10	10	7	6	-3	-3	-3	-3	6	6	3
4718	2	10	10	1	1	1	10	6	2	8	8	-1	-1	-1	8	4	0
4720	4	10	3	3	3	3	10	7	5	6	-1	-1	-1	-1	6	3	1
4724	2	10	10	2	2	2	10	10	2	8	8	0	0	0	8	8	0
4726	6	10	9	5	5	5	10	10	5	4	3	-1	-1	-1	4	4	-1
4732	3	10	9	2	2	2	10	10	2	7	6	-1	-1	-1	7	7	-1
4735	5	10	10	1	1	1	10	3	4	5	5	-4	-4	-4	5	-2	-1
4740	1	10	10	1	1	1	10	10	1	9	9	0	0	0	9	9	0
4741	1	10	10	0	0	0	10	10	1	9	9	-1	-1	-1	9	9	0
4742	4	10	10	2	2	2	10	6	1	6	6	-2	-2	-2	6	2	-3
4746	1	10	2	1	1	1	10	3	1	9	1	0	0	0	9	2	0
4747	3	10	1	2	2	2	10	4	4	7	-2	-1	-1	-1	7	1	1
4750	1	10	4	1	1	1	10	1	1	9	3	0	0	0	9	0	0
4751	1	10	8	1	1	1	10	5	4	9	7	0	0	0	9	4	3
4752	7	10	4	3	3	3	10	9	3	3	-3	-4	-4	-4	3	2	-4
4759	5	10	10	1	1	1	10	10	4	5	5	-4	-4	-4	5	5	-1
4764	1	10	10	1	1	1	10	10	5	9	9	0	0	0	9	9	4
4765	3	10	2	2	2	2	10	1	3	7	-1	-1	-1	-1	7	-2	0
4768	3	10	1	2	2	2	10	2	3	7	-2	-1	-1	-1	7	-1	0
4771	3	10	9	2	2	2	10	10	1	7	6	-1	-1	-1	7	7	-2
4774	6	10	10	2	2	2	10	10	3	4	4	-4	-4	-4	4	4	-3
4780	7	10	7	2	2	2	10	10	8	3	0	-5	-5	-5	3	3	1
4787	7	10	10	2	2	2	10	10	5	3	3	-5	-5	-5	3	3	-2
4794	2	10	2	2	1	1	10	3	3	8	0	0	-1	-1	8	1	1
4796	2	10	10	1	1	1	10	3	1	8	8	-1	-1	-1	8	1	-1
4798	2	10	6	2	2	2	10	10	1	8	4	0	0	0	8	8	-1
4800	2	10	3	1	1	1	10	10	3	8	1	-1	-1	-1	8	8	1
4802	1	10	10	1	1	1	10	10	1	9	9	0	0	0	9	9	0
4803	1	10	3	1	1	1	10	3	2	9	2	0	0	0	9	2	1
4804	2	10	1	1	1	1	10	4	1	8	-1	-1	-1	-1	8	2	-1
4806	2	10	5	1	1	1	10	10	1	8	3	-1	-1	-1	8	8	-1
4808	4	10	10	1	1	1	10	10	2	6	6	-3	-3	-3	6	6	-2
4812	1	10	1	1	1	1	10	3	4	9	0	0	0	0	9	2	3
4813	5	10	10	3	3	3	10	10	2	5	5	-2	-2	-2	5	5	-3
4818	1	10	10	1	1	1	10	10	1	9	9	0	0	0	9	9	0
4819	4	10	10	1	1	1	10	10	2	6	6	-3	-3	-3	6	6	-2
4823	1	10	8	1	1	1	10	10	2	9	7	0	0	0	9	9	1
4824	1	10	10	1	1	1	10	10	4	9	9	0	0	0	9	9	3
4825	2	10	1	2	2	2	10	2	3	8	-1	0	0	0	8	0	1
4827	4	10	6	3	3	3	10	10	3	6	2	-1	-1	-1	6	6	-1
4831	6	10	2	3	3	3	10	10	3	4	-4	-3	-3	-3	4	4	-3
4837	2	10	10	2	2	2	10	10	3	8	8	0	0	0	8	8	1
4839	2	10	10	2	2	2	10	10	1	8	8	0	0	0	8	8	-1
4841	4	10	5	4	4	4	10	10	3	6	1	0	0	0	6	6	-1
4845	2	10	1	1	2	2	10	3	6	8	-1	-1	0	0	8	1	4
4847	4	10	10	3	3	3	10	10	4	6	6	-1	-1	-1	6	6	0
4851	3	10	4	2	2	2	10	9	1	7	1	-1	-1	-1	7	6	-2
4854	2	10	6	2	2	2	10	9	1	8	4	0	0	0	8	7	-1
4856	1	10	3	1	1	1	10	1	3	9	2	0	0	0	9	0	2
4857	6	10	2	4	5	5	10	9	3	4	-4	-2	-1	-1	4	3	-3
4863	4	10	2	2	2	2	10	2	3	6	-2	-2	-2	-2	6	-2	-1
4867	2	10	3	1	1	1	10	10	3	8	1	-1	-1	-1	8	8	1
4869	1	10	2	1	1	1	10	1	1	9	1	0	0	0	9	0	0
4870	3	10	3	2	2	2	10	10	3	7	0	-1	-1	-1	7	7	0
4873	1	10	2	0	0	0	10	2	2	9	1	-1	-1	-1	9	1	1
4874	3	10	4	0	0	0	10	1	1	7	1	-3	-3	-3	7	-2	-2
4877	2	10	1	1	1	1	10	1	3	8	-1	-1	-1	-1	8	-1	1
4879	1	0	0	0	0	0	10	1	4	-1	-1	-1	-1	-1	9	0	3
4880	6	10	6	5	3	3	10	3	4	4	0	-1	-3	-3	4	-3	-2
4886	2	10	6	1	1	1	10	3	4	8	4	-1	-1	-1	8	1	2
4888	3	10	2	1	1	1	10	1	1	7	-1	-2	-2	-2	7	-2	-2
4891	2	10	10	1	1	1	10	1	4	8	8	-1	-1	-1	8	-1	2
4893	1	10	2	1	1	1	10	4	3	9	1	0	0	0	9	3	2
4894	2	10	1	2	2	2	10	10	2	8	-1	0	0	0	8	8	0
4896	2	10	2	2	2	2	10	1	1	8	0	0	0	0	8	-1	-1
4898	1	10	2	1	1	1	10	1	2	9	1	0	0	0	9	0	1
4899	2	10	10	2	2	2	10	6	4	8	8	0	0	0	8	4	2
4901	1	10	1	0	0	0	10	4	2	9	0	-1	-1	-1	9	3	1
4902	2	10	4	2	2	2	10	1	1	8	2	0	0	0	8	-1	-1
4904	1	10	1	1	1	1	10	4	4	9	0	0	0	0	9	3	3
4905	3	10	2	3	3	3	10	1	4	7	-1	0	0	0	7	-2	1
4908	1	10	2	1	1	1	10	4	3	9	1	0	0	0	9	3	2
4909	2	10	6	2	2	2	10	10	2	8	4	0	0	0	8	8	0
4911	6	10	10	2	2	2	10	10	2	4	4	-4	-4	-4	4	4	-4
4917	3	10	1	3	3	3	10	2	4	7	-2	0	0	0	7	-1	1
4920	7	10	10	3	3	3	10	10	2	3	3	-4	-4	-4	3	3	-5
4927	3	10	2	2	2	2	10	10	2	7	-1	-1	-1	-1	7	7	-1
4930	2	10	10	1	1	1	10	9	4	8	8	-1	-1	-1	8	7	2
4932	2	10	10	2	2	2	10	3	2	8	8	0	0	0	8	1	0
4934	1	10	3	1	1	1	10	9	2	9	2	0	0	0	9	8	1
4935	3	10	6	3	3	3	10	1	2	7	3	0	0	0	7	-2	-1
4938	2	10	4	1	1	1	10	10	5	8	2	-1	-1	-1	8	8	3
4940	5	10	1	1	1	1	10	2	2	5	-4	-4	-4	-4	5	-3	-3
4945	2	10	1	1	1	1	10	10	3	8	-1	-1	-1	-1	8	8	1
4947	1	10	10	1	1	1	10	10	1	9	9	0	0	0	9	9	0
4948	1	10	4	1	1	1	10	10	3	9	3	0	0	0	9	9	2
4949	3	10	10	1	1	1	10	10	1	7	7	-2	-2	-2	7	7	-2
4952	3	10	10	1	1	1	10	10	6	7	7	-2	-2	-2	7	7	3
4955	1	0	0	0	0	0	10	8	2	-1	-1	-1	-1	-1	9	7	1
4956	1	10	10	1	1	1	10	10	2	9	9	0	0	0	9	9	1
4957	3	10	10	3	3	3	10	10	4	7	7	0	0	0	7	7	1
4960	1	10	2	1	1	1	10	10	4	9	1	0	0	0	9	9	3
4961	6	10	4	4	4	4	10	2	2	4	-2	-2	-2	-2	4	-4	-4
4967	7	10	10	6	6	6	10	7	2	3	3	-1	-1	-1	3	0	-5
4974	2	10	2	0	0	0	10	2	3	8	0	-2	-2	-2	8	0	1
4976	3	10	2	1	1	1	10	10	4	7	-1	-2	-2	-2	7	7	1
4979	4	10	1	1	1	1	10	1	3	6	-3	-3	-3	-3	6	-3	-1
4983	3	10	10	2	2	2	10	10	1	7	7	-1	-1	-1	7	7	-2
4986	1	10	1	1	1	1	10	2	1	9	0	0	0	0	9	1	0
4987	5	10	1	5	4	4	10	10	2	5	-4	0	-1	-1	5	5	-3
4992	2	10	1	2	2	2	10	10	1	8	-1	0	0	0	8	8	-1
4994	3	10	1	3	3	3	10	6	2	7	-2	0	0	0	7	3	-1
4997	2	10	1	1	1	1	10	1	2	8	-1	-1	-1	-1	8	-1	0
4999	7	10	10	3	3	3	10	10	2	3	3	-4	-4	-4	3	3	-5
5006	2	10	10	0	0	0	10	10	1	8	8	-2	-2	-2	8	8	-1
5008	4	10	1	3	3	3	10	10	4	6	-3	-1	-1	-1	6	6	0
5012	4	10	2	3	3	3	10	10	1	6	-2	-1	-1	-1	6	6	-3
5016	5	10	3	3	3	3	10	10	1	5	-2	-2	-2	-2	5	5	-4
5021	2	10	1	2	2	2	10	1	2	8	-1	0	0	0	8	-1	0
5023	3	10	3	2	2	2	10	7	1	7	0	-1	-1	-1	7	4	-2
5026	1	10	10	0	0	0	10	10	4	9	9	-1	-1	-1	9	9	3
5027	1	10	10	1	1	1	10	10	4	9	9	0	0	0	9	9	3
5028	1	10	1	1	1	1	10	1	2	9	0	0	0	0	9	0	1
5029	1	10	9	1	1	1	10	1	1	9	8	0	0	0	9	0	0
5030	1	10	6	1	1	1	10	6	2	9	5	0	0	0	9	5	1
5031	4	10	3	2	2	2	10	1	3	6	-1	-2	-2	-2	6	-3	-1
5035	4	10	10	1	1	1	10	10	4	6	6	-3	-3	-3	6	6	0
5039	1	10	10	1	1	1	10	10	1	9	9	0	0	0	9	9	0
5040	5	10	10	3	3	3	10	10	2	5	5	-2	-2	-2	5	5	-3
5045	2	10	3	2	2	2	10	3	4	8	1	0	0	0	8	1	2
5047	1	10	1	1	1	1	10	4	4	9	0	0	0	0	9	3	3
5048	1	10	1	1	1	1	10	10	2	9	0	0	0	0	9	9	1
5049	1	10	1	1	1	1	10	1	3	9	0	0	0	0	9	0	2
5050	2	10	10	1	1	1	10	10	2	8	8	-1	-1	-1	8	8	0
5052	1	10	3	0	0	0	10	3	1	9	2	-1	-1	-1	9	2	0
5053	3	10	10	1	1	1	10	10	2	7	7	-2	-2	-2	7	7	-1
5056	2	10	1	1	1	1	10	3	1	8	-1	-1	-1	-1	8	1	-1
5058	1	10	5	1	1	1	10	10	4	9	4	0	0	0	9	9	3
5059	2	10	4	2	2	2	10	10	2	8	2	0	0	0	8	8	0
5061	1	10	6	0	0	0	10	10	3	9	5	-1	-1	-1	9	9	2
5062	1	10	10	1	1	1	10	10	1	9	9	0	0	0	9	9	0
5063	2	10	3	1	1	1	10	3	2	8	1	-1	-1	-1	8	1	0
5065	3	10	1	1	1	1	10	4	2	7	-2	-2	-2	-2	7	1	-1
5068	1	10	1	1	1	1	10	1	1	9	0	0	0	0	9	0	0
5069	2	10	10	2	2	2	10	10	2	8	8	0	0	0	8	8	0
5071	1	1	1	0	0	0	10	1	3	0	0	-1	-1	-1	9	0	2
5072	2	10	1	1	1	1	10	10	3	8	-1	-1	-1	-1	8	8	1
5074	1	10	1	1	1	1	10	4	1	9	0	0	0	0	9	3	0
5075	1	10	10	1	1	1	10	10	2	9	9	0	0	0	9	9	1
5076	1	10	3	0	0	0	10	10	2	9	2	-1	-1	-1	9	9	1
5077	6	10	1	6	5	5	10	10	1	4	-5	0	-1	-1	4	4	-5
5083	3	10	10	2	2	2	10	10	4	7	7	-1	-1	-1	7	7	1
5086	2	10	1	1	1	1	10	10	2	8	-1	-1	-1	-1	8	8	0
5088	1	10	4	1	1	1	10	10	5	9	3	0	0	0	9	9	4
5089	2	10	1	2	2	2	10	2	2	8	-1	0	0	0	8	0	0
5091	2	10	1	2	2	2	10	2	1	8	-1	0	0	0	8	0	-1
5093	2	10	6	2	2	2	10	5	5	8	4	0	0	0	8	3	3
5095	5	10	1	2	2	2	10	10	6	5	-4	-3	-3	-3	5	5	1
5100	2	10	3	1	1	1	10	10	1	8	1	-1	-1	-1	8	8	-1
5102	2	10	4	2	2	2	10	6	3	8	2	0	0	0	8	4	1
5104	5	10	5	4	4	4	10	5	2	5	0	-1	-1	-1	5	0	-3
5109	1	10	1	1	1	1	10	1	2	9	0	0	0	0	9	0	1
5110	5	10	10	2	2	2	10	10	3	5	5	-3	-3	-3	5	5	-2
5115	1	10	3	0	0	0	10	7	2	9	2	-1	-1	-1	9	6	1
5116	1	10	3	1	1	1	10	3	2	9	2	0	0	0	9	2	1
5117	2	10	10	2	2	2	10	9	1	8	8	0	0	0	8	7	-1
5119	1	10	1	0	0	0	10	10	1	9	0	-1	-1	-1	9	9	0
5120	2	10	2	2	2	2	10	2	4	8	0	0	0	0	8	0	2
5122	3	10	10	2	2	2	10	10	3	7	7	-1	-1	-1	7	7	0
5125	3	10	2	2	2	2	10	5	4	7	-1	-1	-1	-1	7	2	1
5128	1	10	2	1	1	1	10	3	1	9	1	0	0	0	9	2	0
5129	2	10	2	1	1	1	10	10	1	8	0	-1	-1	-1	8	8	-1
5131	1	10	3	0	0	0	10	3	1	9	2	-1	-1	-1	9	2	0
5132	1	10	1	1	1	1	10	1	1	9	0	0	0	0	9	0	0
5133	5	10	10	1	1	1	10	10	2	5	5	-4	-4	-4	5	5	-3
5138	1	10	6	1	1	1	10	4	5	9	5	0	0	0	9	3	4
5139	2	10	1	2	2	2	10	10	1	8	-1	0	0	0	8	8	-1
5141	3	10	2	0	0	0	10	2	6	7	-1	-3	-3	-3	7	-1	3
5144	3	10	1	1	1	1	10	1	1	7	-2	-2	-2	-2	7	-2	-2
5147	2	10	9	1	2	2	10	10	2	8	7	-1	0	0	8	8	0
5149	1	10	1	1	1	1	10	1	3	9	0	0	0	0	9	0	2
5150	1	10	10	1	1	1	10	4	2	9	9	0	0	0	9	3	1
5151	1	5	1	1	1	1	10	1	2	4	0	0	0	0	9	0	1
5152	2	10	1	1	1	1	10	6	2	8	-1	-1	-1	-1	8	4	0
5154	2	10	3	2	2	2	10	3	2	8	1	0	0	0	8	1	0
5156	2	10	4	2	2	2	10	10	2	8	2	0	0	0	8	8	0
5158	1	10	1	1	1	1	10	1	1	9	0	0	0	0	9	0	0
5159	1	10	8	0	0	0	10	2	1	9	7	-1	-1	-1	9	1	0
5160	2	10	1	1	1	1	10	8	1	8	-1	-1	-1	-1	8	6	-1
5162	2	10	2	1	1	1	10	10	1	8	0	-1	-1	-1	8	8	-1
5164	2	10	5	1	2	2	10	10	1	8	3	-1	0	0	8	8	-1
5166	1	9	1	1	1	1	10	3	1	8	0	0	0	0	9	2	0
5167	2	10	2	2	2	2	10	3	1	8	0	0	0	0	8	1	-1
5169	1	10	1	1	1	1	10	10	2	9	0	0	0	0	9	9	1
5170	1	10	1	0	0	0	10	1	1	9	0	-1	-1	-1	9	0	0
5171	1	10	10	1	1	1	10	1	3	9	9	0	0	0	9	0	2
5172	2	10	1	2	2	2	10	7	1	8	-1	0	0	0	8	5	-1
5174	2	10	3	1	1	1	10	1	1	8	1	-1	-1	-1	8	-1	-1
5176	1	10	6	1	1	1	10	10	1	9	5	0	0	0	9	9	0
5177	2	10	6	1	1	1	10	7	3	8	4	-1	-1	-1	8	5	1
5179	2	10	1	1	1	1	10	5	3	8	-1	-1	-1	-1	8	3	1
5181	2	10	3	1	1	1	10	2	6	8	1	-1	-1	-1	8	0	4
5183	2	10	10	2	2	2	10	10	2	8	8	0	0	0	8	8	0
5185	1	10	10	1	1	1	10	10	2	9	9	0	0	0	9	9	1
5186	1	10	1	1	1	1	10	1	1	9	0	0	0	0	9	0	0
5187	1	10	1	1	1	1	10	2	3	9	0	0	0	0	9	1	2
5188	2	10	1	1	1	1	10	7	2	8	-1	-1	-1	-1	8	5	0
5190	2	10	1	2	2	2	10	6	3	8	-1	0	0	0	8	4	1
5192	1	10	6	1	1	1	10	2	1	9	5	0	0	0	9	1	0
5193	4	10	2	3	3	3	10	4	1	6	-2	-1	-1	-1	6	0	-3
5197	1	10	1	1	1	1	10	2	1	9	0	0	0	0	9	1	0
5198	1	10	1	1	1	1	10	1	2	9	0	0	0	0	9	0	1
5199	2	10	2	1	1	1	10	4	1	8	0	-1	-1	-1	8	2	-1
5201	1	0	0	0	0	0	3	1	3	-1	-1	-1	-1	-1	2	0	2
5202	2	10	4	2	2	2	10	10	2	8	2	0	0	0	8	8	0
5204	3	10	2	2	2	2	10	10	1	7	-1	-1	-1	-1	7	7	-2
5207	2	10	1	2	2	2	10	1	1	8	-1	0	0	0	8	-1	-1
5209	3	10	3	1	1	1	10	4	3	7	0	-2	-2	-2	7	1	0
5212	4	10	4	1	1	1	10	4	3	6	0	-3	-3	-3	6	0	-1
5216	1	10	9	1	1	1	10	1	3	9	8	0	0	0	9	0	2
5217	1	10	10	1	1	1	10	10	2	9	9	0	0	0	9	9	1
5218	1	10	1	1	1	1	10	10	1	9	0	0	0	0	9	9	0
5219	2	10	10	2	2	2	10	10	4	8	8	0	0	0	8	8	2
5221	1	10	1	1	1	1	10	4	2	9	0	0	0	0	9	3	1
5222	2	10	2	2	2	2	10	9	4	8	0	0	0	0	8	7	2
5224	3	10	10	2	2	2	10	10	3	7	7	-1	-1	-1	7	7	0
5227	2	10	10	1	1	1	10	10	1	8	8	-1	-1	-1	8	8	-1
5229	2	10	1	0	0	0	10	3	1	8	-1	-2	-2	-2	8	1	-1
5231	1	10	8	0	0	0	10	10	1	9	7	-1	-1	-1	9	9	0
5232	2	10	6	1	1	1	10	10	2	8	4	-1	-1	-1	8	8	0
5234	2	10	3	2	2	2	10	3	3	8	1	0	0	0	8	1	1
5236	2	10	10	2	2	2	10	10	2	8	8	0	0	0	8	8	0
5238	3	10	3	3	3	3	10	10	1	7	0	0	0	0	7	7	-2
5241	1	10	1	0	0	0	10	10	1	9	0	-1	-1	-1	9	9	0
5242	1	10	5	0	0	0	10	10	1	9	4	-1	-1	-1	9	9	0
5243	1	10	1	1	1	1	10	1	4	9	0	0	0	0	9	0	3
5244	1	10	1	1	1	1	10	2	8	9	0	0	0	0	9	1	7
5245	4	10	3	4	4	4	10	10	1	6	-1	0	0	0	6	6	-3
5249	4	10	3	3	3	3	10	9	4	6	-1	-1	-1	-1	6	5	0
5253	3	10	9	2	2	2	10	7	1	7	6	-1	-1	-1	7	4	-2
5256	2	10	4	2	2	2	10	4	2	8	2	0	0	0	8	2	0
5258	1	10	3	1	1	1	10	1	1	9	2	0	0	0	9	0	0
5259	3	10	1	2	2	2	10	1	3	7	-2	-1	-1	-1	7	-2	0
5262	1	10	10	0	0	0	10	8	2	9	9	-1	-1	-1	9	7	1
5263	1	10	1	1	1	1	10	4	2	9	0	0	0	0	9	3	1
5264	2	10	1	1	1	1	10	1	2	8	-1	-1	-1	-1	8	-1	0
5266	1	10	1	0	0	0	10	5	4	9	0	-1	-1	-1	9	4	3
5267	2	10	6	0	0	0	10	10	4	8	4	-2	-2	-2	8	8	2
